name	taxonomy_id	taxonomy_lvl	kraken_assigned_reads	added_reads	new_est_reads	fraction_total_reads
Faecalibacterium	216851	G	1051518	58634	1110152	0.15137
Ruminococcus	1263	G	203650	13222	216872	0.02957
Vescimonas	2892396	G	60177	5813	65990	0.00900
Lawsonibacter	2172004	G	33430	1168	34598	0.00472
Flavonifractor	946234	G	19789	735	20524	0.00280
Anaerotruncus	244127	G	17675	1472	19147	0.00261
Subdoligranulum	292632	G	16813	641	17454	0.00238
Oscillibacter	459786	G	11742	17481	29223	0.00398
Pusillibacter	2892397	G	9045	549	9594	0.00131
Ruthenibacterium	1905344	G	7426	248	7674	0.00105
Dysosmobacter	2591381	G	4637	12163	16800	0.00229
Pseudoflavonifractor	1017280	G	3739	157	3896	0.00053
Owariibacterium	3393728	G	2859	242	3101	0.00042
Caproicibacterium	2834348	G	2262	84	2346	0.00032
Solibaculum	2842531	G	1678	139	1817	0.00025
Bengtsoniella	3389389	G	564	2	566	0.00008
Ethanoligenens	253238	G	543	13	556	0.00008
Thermocaproicibacter	3048127	G	316	6	322	0.00004
Paludihabitans	2038676	G	264	0	264	0.00004
Amygdalobacter	3079925	G	240	9	249	0.00003
Acetivibrio	35829	G	211	25	236	0.00003
Ruminiclostridium	1508657	G	195	6	201	0.00003
Mageeibacillus	1637257	G	147	10	157	0.00002
Petroclostridium	2304687	G	112	0	112	0.00002
Thermoclostridium	2304691	G	105	3	108	0.00001
Fastidiosipila	236752	G	34	1	35	0.00000
Clostridium	1485	G	16089	1689	17778	0.00242
Lactonifactor	420345	G	952	34	986	0.00013
Haloimpatiens	1755832	G	467	19	486	0.00007
Proteiniclasticum	1155385	G	165	4	169	0.00002
Crassaminicella	1848399	G	108	1	109	0.00001
Wukongibacter	1884926	G	94	0	94	0.00001
Caloramator	44258	G	88	1	89	0.00001
Oceanirhabdus	1434026	G	43	0	43	0.00001
Candidatus Arthromitus	49082	G	36	0	36	0.00000
Hathewaya	1769729	G	20	0	20	0.00000
Sarcina	1266	G	18	0	18	0.00000
Eubacterium	1730	G	14861	1266	16127	0.00220
Acetobacterium	33951	G	362	3	365	0.00005
Pseudoramibacter	113286	G	214	1	215	0.00003
Anaerofustis	264995	G	205	5	210	0.00003
Alkalibacter	274470	G	49	0	49	0.00001
Intestinimonas	1392389	G	9219	323	9542	0.00130
Flintibacter	1918454	G	3357	108	3465	0.00047
Thermaerobacter	73918	G	153	0	153	0.00002
Sulfobacillus	28033	G	12	0	12	0.00000
Levyella	1715798	G	81	3	84	0.00001
Proteiniborus	415014	G	71	1	72	0.00001
Fenollaria	1686313	G	65	2	67	0.00001
Fusibacter	76008	G	52	0	52	0.00001
Carboxydocella	178898	G	51	0	51	0.00001
Agathobaculum	2048137	G	3262	1944	5206	0.00071
Butyricicoccus	580596	G	1165	45	1210	0.00016
Intestinibacillus	1928820	G	340	428	768	0.00010
Acutalibacter	1918385	G	1319	14	1333	0.00018
Caproiciproducens	1738645	G	1011	58	1069	0.00015
Caproicibacter	2576755	G	474	345	819	0.00011
Dehalobacter	56112	G	283	12	295	0.00004
Desulfosporosinus	79206	G	272	1	273	0.00004
Desulfitobacterium	36853	G	259	5	264	0.00004
Syntrophobotulus	51196	G	80	0	80	0.00001
Aristaeella	3046369	G	677	0	677	0.00009
Desulforamulus	2916693	G	156	5	161	0.00002
Dehalobacterium	51514	G	101	6	107	0.00001
Candidatus Formimonas	2840454	G	61	0	61	0.00001
Desulfofundulus	2282741	G	53	0	53	0.00001
Acididesulfobacillus	2924872	G	44	0	44	0.00001
Thermanaerosceptrum	2651578	G	43	0	43	0.00001
Phosphitispora	2903061	G	32	1	33	0.00000
Desulfofarcimen	2282742	G	31	0	31	0.00000
Desulfoscipio	2867376	G	163	0	163	0.00002
Caldinitratiruptor	1006480	G	55	0	55	0.00001
Symbiobacterium	2733	G	51	0	51	0.00001
Heliomicrobium	2831443	G	81	1	82	0.00001
Proteinivorax	1491776	G	49	0	49	0.00001
Alkalicella	2838170	G	10	0	10	0.00000
Syntrophomonas	862	G	21	0	21	0.00000
Syntrophothermus	129001	G	16	0	16	0.00000
Thermincola	278993	G	43	0	43	0.00001
Desulfotomaculum	1562	G	23	2	25	0.00000
Agathobacter	1766253	G	366438	49699	416137	0.05674
Blautia	572511	G	322116	84036	406152	0.05538
Mediterraneibacter	2316020	G	130685	12569	143254	0.01953
Roseburia	841	G	78915	12095	91010	0.01241
Dorea	189330	G	72819	8643	81462	0.01111
Anaerostipes	207244	G	47686	2421	50107	0.00683
Anaerobutyricum	2569097	G	36833	4011	40844	0.00557
Coprococcus	33042	G	35131	28063	63194	0.00862
Enterocloster	2719313	G	22387	839	23226	0.00317
Lachnoclostridium	1506553	G	12253	443	12696	0.00173
Hungatella	1649459	G	7106	309	7415	0.00101
Eisenbergiella	1432051	G	5993	277	6270	0.00085
Simiaoa	2944193	G	5842	454	6296	0.00086
Sellimonas	1769710	G	4915	340	5255	0.00072
Lachnospira	28050	G	4206	114	4320	0.00059
Lacrimispora	2719231	G	3709	24	3733	0.00051
Wansuia	2944198	G	2326	46	2372	0.00032
Eshraghiella	3342669	G	2233	130	2363	0.00032
Otoolea	2941495	G	2144	80	2224	0.00030
Butyrivibrio	830	G	1482	7	1489	0.00020
Anaerocolumna	1843210	G	1366	2	1368	0.00019
Marvinbryantia	248744	G	1251	22	1273	0.00017
Claveliimonas	3076670	G	1009	38	1047	0.00014
Wujia	2944152	G	922	86	1008	0.00014
Qiania	2944195	G	859	23	882	0.00012
Novisyntrophococcus	2888809	G	845	14	859	0.00012
Faecalimonas	2005355	G	689	77	766	0.00010
Kineothrix	2163168	G	660	2	662	0.00009
Hominifimenecus	3073585	G	482	0	482	0.00007
Chordicoccus	3031933	G	474	5	479	0.00007
Lachnoanaerobaculum	1164882	G	400	7	407	0.00006
Stomatobaculum	1213720	G	393	1	394	0.00005
Pseudobutyrivibrio	46205	G	286	1	287	0.00004
Chakrabartyella	3088373	G	252	1	253	0.00003
Anaeromicropila	3024823	G	245	0	245	0.00003
Tyzzerella	1506577	G	147	0	147	0.00002
Anaeropeptidivorans	2997360	G	146	0	146	0.00002
Herbinix	1663717	G	116	5	121	0.00002
Sporofaciens	2811390	G	40	0	40	0.00001
Candidatus Epulonipiscium	2383	G	34	0	34	0.00000
Anaerotignum	2039240	G	834	19	853	0.00012
Vallitalea	1348611	G	165	2	167	0.00002
Petrocella	2603323	G	45	1	46	0.00001
Cellulosilyticum	698776	G	123	0	123	0.00002
Defluviitalea	1185408	G	87	3	90	0.00001
Clostridioides	1870884	G	4023	637	4660	0.00064
Terrisporobacter	1505652	G	202	2	204	0.00003
Peptostreptococcus	1257	G	198	13	211	0.00003
Paraclostridium	1849822	G	141	2	143	0.00002
Romboutsia	1501226	G	125	4	129	0.00002
Peptacetobacter	2743582	G	125	2	127	0.00002
Intestinibacter	1505657	G	112	3	115	0.00002
Tepidibacter	214904	G	68	0	68	0.00001
Emergencia	1926556	G	2202	57	2259	0.00031
Aminipila	2060094	G	337	1	338	0.00005
Ihubacter	1926667	G	252	9	261	0.00004
Mogibacterium	86331	G	215	4	219	0.00003
Anoxybacterium	3408579	G	109	0	109	0.00001
Sinanaerobacter	2886866	G	93	0	93	0.00001
Filifactor	44259	G	73	5	78	0.00001
Acetoanaerobium	186831	G	40	0	40	0.00001
Geosporobacter	390805	G	94	0	94	0.00001
Alkaliphilus	114627	G	68	0	68	0.00001
Serpentinicella	1890059	G	13	0	13	0.00000
Caminicella	166484	G	42	0	42	0.00001
Peptoclostridium	1481960	G	38	0	38	0.00001
Christensenella	990721	G	2303	52	2355	0.00032
Thermoanaerobacterium	28895	G	223	4	227	0.00003
Thermoanaerobacter	1754	G	179	1	180	0.00002
Gelria	189326	G	88	0	88	0.00001
Aceticella	3051499	G	66	0	66	0.00001
Thermacetogenium	140458	G	51	1	52	0.00001
Carboxydothermus	129957	G	23	0	23	0.00000
Ammonifex	42837	G	13	0	13	0.00000
Caldanaerobacter	249529	G	12	0	12	0.00000
Candidatus Desulforudis	471826	G	89	0	89	0.00001
Mahella	252965	G	56	1	57	0.00001
Neomoorella	44260	G	259	0	259	0.00004
Thermanaeromonas	202949	G	30	0	30	0.00000
Zhaonella	2748674	G	61	0	61	0.00001
Metallumcola	3234175	G	44	0	44	0.00001
Monoglobus	2039302	G	260	11	271	0.00004
Halanaerobium	2330	G	88	0	88	0.00001
Halocella	46466	G	21	25	46	0.00001
Acetohalobium	28186	G	29	0	29	0.00000
Natroniella	52003	G	21	0	21	0.00000
Anoxybacter	1769008	G	15	0	15	0.00000
Halothermothrix	32636	G	11	0	11	0.00000
Biomaibacter	2770094	G	37	0	37	0.00001
Tepidanaerobacter	499228	G	15	0	15	0.00000
Thermosediminibacter	291988	G	32	0	32	0.00000
Natranaerobius	375928	G	27	0	27	0.00000
Natranaerofaba	2807497	G	25	0	25	0.00000
Koleobacter	2786989	G	48	0	48	0.00001
Helicovermis	3136917	G	37	0	37	0.00001
Staphylococcus	1279	G	80106	34102	114208	0.01557
Macrococcus	69965	G	156	2	158	0.00002
Mammaliicoccus	2803850	G	110	1	111	0.00002
Salinicoccus	45669	G	52	0	52	0.00001
Jeotgalicoccus	227979	G	36	0	36	0.00000
Nosocomiicoccus	489909	G	31	0	31	0.00000
Macrococcoides	3076173	G	31	0	31	0.00000
Paenibacillus	44249	G	7283	128	7411	0.00101
Brevibacillus	55080	G	1118	16	1134	0.00015
Cohnella	329857	G	341	28	369	0.00005
Aneurinibacillus	55079	G	112	1	113	0.00002
Thermobacillus	76632	G	96	5	101	0.00001
Saccharibacillus	456492	G	70	1	71	0.00001
Candidatus Pristimantibacillus	2994560	G	24	3	27	0.00000
Bacillus	1386	G	2254	566	2820	0.00038
Neobacillus	2675232	G	691	23	714	0.00010
Lysinibacillus	400634	G	542	13	555	0.00008
Peribacillus	2675229	G	473	13	486	0.00007
Cytobacillus	2675230	G	299	99	398	0.00005
Priestia	2800373	G	287	12	299	0.00004
Halobacillus	45667	G	260	3	263	0.00004
Virgibacillus	84406	G	246	3	249	0.00003
Mesobacillus	2675231	G	229	7	236	0.00003
Oceanobacillus	182709	G	228	3	231	0.00003
Niallia	2837506	G	225	6	231	0.00003
Metabacillus	2675233	G	217	8	225	0.00003
Rossellomorea	2837508	G	169	4	173	0.00002
Heyndrickxia	2837504	G	123	6	129	0.00002
Psychrobacillus	1221880	G	116	1	117	0.00002
Sutcliffiella	2837511	G	98	3	101	0.00001
Alkalihalobacillus	2675234	G	95	1	96	0.00001
Terribacillus	459532	G	93	1	94	0.00001
Shouchella	2893057	G	68	1	69	0.00001
Salipaludibacillus	1884449	G	65	0	65	0.00001
Lentibacillus	175304	G	62	0	62	0.00001
Radiobacillus	2785518	G	58	1	59	0.00001
Fervidibacillus	3033930	G	56	1	57	0.00001
Pontibacillus	289201	G	55	0	55	0.00001
Gottfriedia	2837503	G	54	0	54	0.00001
Caldifermentibacillus	3034001	G	53	149	202	0.00003
Salicibibacter	2685905	G	50	0	50	0.00001
Salimicrobium	351195	G	45	0	45	0.00001
Gracilibacillus	74385	G	40	0	40	0.00001
Siminovitchia	2837510	G	40	0	40	0.00001
Robertmurraya	2837507	G	35	1	36	0.00000
Salisediminibacterium	1434042	G	35	0	35	0.00000
Evansella	2837485	G	34	0	34	0.00000
Pradoshia	2651279	G	29	0	29	0.00000
Paraliobacillus	200903	G	28	0	28	0.00000
Caldalkalibacillus	379065	G	28	0	28	0.00000
Pseudobacillus	108525	G	27	1	28	0.00000
Aeribacillus	1055323	G	27	3	30	0.00000
Domibacillus	1433999	G	27	0	27	0.00000
Sediminibacillus	482460	G	26	0	26	0.00000
Ornithinibacillus	484508	G	24	0	24	0.00000
Lederbergia	2804231	G	20	0	20	0.00000
Ectobacillus	2837502	G	17	0	17	0.00000
Alkalihalophilus	2893060	G	15	0	15	0.00000
Halalkalibacter	2893056	G	14	0	14	0.00000
Alkalicoccus	2005375	G	14	0	14	0.00000
Falsibacillus	1270155	G	14	0	14	0.00000
Paenalkalicoccus	2944627	G	13	1	14	0.00000
Mangrovibacillus	2920444	G	12	0	12	0.00000
Aciduricibacillus	3158337	G	12	0	12	0.00000
Alkalibacillus	331654	G	11	0	11	0.00000
Amphibacillus	29331	G	11	0	11	0.00000
Allobacillus	1400133	G	10	0	10	0.00000
Sporosarcina	1569	G	453	5	458	0.00006
Planococcus	1372	G	361	4	365	0.00005
Solibacillus	648800	G	103	1	104	0.00001
Ureibacillus	160795	G	77	2	79	0.00001
Rummeliibacillus	648802	G	64	1	65	0.00001
Paenisporosarcina	651660	G	56	1	57	0.00001
Kurthia	1649	G	41	2	43	0.00001
Jeotgalibacillus	157226	G	35	0	35	0.00000
Viridibacillus	496496	G	18	0	18	0.00000
Metasolibacillus	2703677	G	16	0	16	0.00000
Chryseomicrobium	889388	G	13	0	13	0.00000
Alicyclobacillus	29330	G	388	2	390	0.00005
Tumebacillus	432330	G	127	4	131	0.00002
Effusibacillus	1502725	G	24	0	24	0.00000
Kyrpidia	1129704	G	18	0	18	0.00000
Fodinisporobacter	3156481	G	18	0	18	0.00000
Geobacillus	129337	G	169	14	183	0.00002
Anoxybacillus	150247	G	81	1	82	0.00001
Parageobacillus	1906945	G	55	8	63	0.00001
Saccharococcus	29395	G	18	1	19	0.00000
Gemella	1378	G	298	16	314	0.00004
Listeria	1637	G	244	3	247	0.00003
Brochothrix	2755	G	28	0	28	0.00000
Exiguobacterium	33986	G	162	1	163	0.00002
Hydrogenibacillus	1609627	G	30	0	30	0.00000
Kroppenstedtia	1274351	G	59	0	59	0.00001
Polycladomyces	1348505	G	56	0	56	0.00001
Laceyella	292635	G	31	0	31	0.00000
Staphylospora	2689589	G	25	0	25	0.00000
Thermoactinomyces	2023	G	10	0	10	0.00000
Novibacillus	1677050	G	10	0	10	0.00000
Fictibacillus	1329200	G	81	0	81	0.00001
Pseudalkalibacillus	2893058	G	24	0	24	0.00000
Sporolactobacillus	2077	G	62	0	62	0.00001
Pullulanibacillus	475230	G	30	0	30	0.00000
Guptibacillus	3421338	G	60	0	60	0.00001
Streptococcus	1301	G	54398	1227	55625	0.00758
Lactococcus	1357	G	821	250	1071	0.00015
Pseudolactococcus	3436058	G	83	2	85	0.00001
Floricoccus	1930830	G	24	0	24	0.00000
Enterococcus	1350	G	5614	5531	11145	0.00152
Vagococcus	2737	G	166	4	170	0.00002
Tetragenococcus	51668	G	68	12	80	0.00001
Lactobacillus	1578	G	843	56	899	0.00012
Ligilactobacillus	2767887	G	427	14	441	0.00006
Limosilactobacillus	2742598	G	220	11	231	0.00003
Leuconostoc	1243	G	192	6	198	0.00003
Lacticaseibacillus	2759736	G	180	15	195	0.00003
Lactiplantibacillus	2767842	G	162	33	195	0.00003
Levilactobacillus	2767886	G	147	8	155	0.00002
Weissella	46255	G	146	2	148	0.00002
Companilactobacillus	2767879	G	125	2	127	0.00002
Pediococcus	1253	G	108	7	115	0.00002
Liquorilactobacillus	2767888	G	92	4	96	0.00001
Fructilactobacillus	2767881	G	57	1	58	0.00001
Lentilactobacillus	2767893	G	55	1	56	0.00001
Latilactobacillus	2767885	G	55	1	56	0.00001
Apilactobacillus	2767877	G	49	0	49	0.00001
Paucilactobacillus	2767890	G	42	1	43	0.00001
Schleiferilactobacillus	2767891	G	40	0	40	0.00001
Bombilactobacillus	2767878	G	37	0	37	0.00001
Loigolactobacillus	2767889	G	34	3	37	0.00001
Oenococcus	46254	G	27	0	27	0.00000
Xylocopilactobacillus	3118928	G	25	0	25	0.00000
Secundilactobacillus	2767892	G	17	1	18	0.00000
Agrilactobacillus	2767875	G	15	0	15	0.00000
Dellaglioa	2767880	G	12	0	12	0.00000
Amylolactobacillus	2767876	G	12	0	12	0.00000
Furfurilactobacillus	2767882	G	10	0	10	0.00000
Carnobacterium	2747	G	127	2	129	0.00002
Granulicatella	117563	G	127	6	133	0.00002
Jeotgalibaca	1470540	G	92	3	95	0.00001
Trichococcus	82802	G	81	2	83	0.00001
Alkalibacterium	99906	G	42	1	43	0.00001
Alloiococcus	1651	G	36	0	36	0.00000
Dolosigranulum	29393	G	23	0	23	0.00000
Aerococcus	1375	G	96	2	98	0.00001
Globicatella	13075	G	62	1	63	0.00001
Abiotrophia	46123	G	33	2	35	0.00000
Facklamia	66831	G	23	1	24	0.00000
Suicoccus	2689587	G	18	0	18	0.00000
Fundicoccus	2761542	G	15	0	15	0.00000
Ruoffia	2862144	G	13	0	13	0.00000
Ignavigranum	89092	G	11	0	11	0.00000
Acidaminococcus	904	G	45267	883	46150	0.00629
Phascolarctobacterium	33024	G	628	11	639	0.00009
Dialister	39948	G	6687	96	6783	0.00092
Megasphaera	906	G	1333	59	1392	0.00019
Veillonella	29465	G	1251	14	1265	0.00017
Selenomonas	970	G	1074	17	1091	0.00015
Megamonas	158846	G	283	7	290	0.00004
Pectinatus	864	G	154	6	160	0.00002
Selenobaculum	3074372	G	74	4	78	0.00001
Sporomusa	2375	G	598	6	604	0.00008
Methylomusa	2093783	G	95	0	95	0.00001
Pelosinus	365348	G	90	1	91	0.00001
Faecalibacillus	2678885	G	11836	649	12485	0.00170
Thomasclavelia	3025755	G	1400	20	1420	0.00019
Catenibacterium	135858	G	221	4	225	0.00003
Tannockella	2943184	G	33	0	33	0.00000
Holdemania	61170	G	3049	125	3174	0.00043
Longicatena	1918536	G	1229	126	1355	0.00018
Amedibacillus	2749846	G	254	22	276	0.00004
Allobaculum	174708	G	177	0	177	0.00002
Faecalibaculum	1729679	G	162	1	163	0.00002
Erysipelothrix	1647	G	155	1	156	0.00002
Solobacterium	123375	G	149	16	165	0.00002
Allocoprobacillus	3059504	G	133	3	136	0.00002
Amedibacterium	2749267	G	130	9	139	0.00002
Intestinibaculum	2679910	G	63	0	63	0.00001
Bulleidia	118747	G	40	1	41	0.00001
Massilimicrobiota	1924110	G	29	52	81	0.00001
Turicibacter	191303	G	168	7	175	0.00002
Anaerococcus	165779	G	148	7	155	0.00002
Murdochiella	1161127	G	143	12	155	0.00002
Parvimonas	543311	G	142	7	149	0.00002
Peptoniphilus	162289	G	134	6	140	0.00002
Finegoldia	150022	G	87	5	92	0.00001
Aedoeadaptatus	2981628	G	54	0	54	0.00001
Helcococcus	31983	G	50	1	51	0.00001
Miniphocaeibacter	2126548	G	35	0	35	0.00000
Tissierella	41273	G	107	0	107	0.00001
Gudongella	2692382	G	44	0	44	0.00001
Acidilutibacter	2992720	G	56	1	57	0.00001
Schnuerera	2794837	G	26	3	29	0.00000
Keratinibaculum	1354809	G	17	2	19	0.00000
Caloranaerobacter	171003	G	31	0	31	0.00000
Sporanaerobacter	165812	G	30	0	30	0.00000
Gottschalkia	1505664	G	19	0	19	0.00000
Sedimentibacter	190972	G	93	0	93	0.00001
Ezakiella	1582879	G	85	10	95	0.00001
Caldicellulosiruptor	44000	G	249	29	278	0.00004
Anaerocellum	32631	G	13	17	30	0.00000
Limnochorda	1676651	G	62	0	62	0.00001
Carboxydichorda	3366853	G	29	1	30	0.00000
Geochorda	3366854	G	20	1	21	0.00000
Ndongobacter	1930845	G	44	2	46	0.00001
Candidatus Contubernalis	338648	G	25	4	29	0.00000
Bifidobacterium	1678	G	86204	735	86939	0.01185
Gardnerella	2701	G	173	9	182	0.00002
Parascardovia	196082	G	26	0	26	0.00000
Scardovia	196081	G	23	0	23	0.00000
Streptomyces	1883	G	15682	732	16414	0.00224
Kitasatospora	2063	G	737	44	781	0.00011
Actinacidiphila	2995702	G	149	7	156	0.00002
Embleya	2699295	G	82	0	82	0.00001
Peterkaempfera	2995704	G	74	2	76	0.00001
Streptacidiphilus	228398	G	47	1	48	0.00001
Yinghuangia	2805681	G	43	0	43	0.00001
Streptantibioticus	2995706	G	15	0	15	0.00000
Carbonactinospora	2864378	G	22	0	22	0.00000
Microbacterium	33882	G	1432	91	1523	0.00021
Curtobacterium	2034	G	842	95	937	0.00013
Leifsonia	110932	G	248	15	263	0.00004
Agromyces	33877	G	197	15	212	0.00003
Leucobacter	55968	G	170	9	179	0.00002
Rathayibacter	33886	G	148	6	154	0.00002
Cryobacterium	69578	G	106	5	111	0.00002
Agrococcus	46352	G	99	8	107	0.00001
Clavibacter	1573	G	93	11	104	0.00001
Microcella	337004	G	79	4	83	0.00001
Herbiconiux	881616	G	60	2	62	0.00001
Mycetocola	76634	G	54	1	55	0.00001
Frigoribacterium	96492	G	44	3	47	0.00001
Aquiluna	529881	G	32	1	33	0.00000
Salinibacterium	235888	G	37	1	38	0.00001
Cnuibacter	1759331	G	37	2	39	0.00001
Frondihabitans	447237	G	30	1	31	0.00000
Plantibacter	190323	G	27	1	28	0.00000
Microterricola	518733	G	25	1	26	0.00000
Subtercola	120212	G	23	0	23	0.00000
Homoserinibacter	1649457	G	23	2	25	0.00000
Protaetiibacter	2680004	G	21	2	23	0.00000
Glaciihabitans	1649454	G	21	0	21	0.00000
Paramicrobacterium	3110364	G	20	0	20	0.00000
Gulosibacter	256818	G	19	1	20	0.00000
Agreia	110934	G	15	0	15	0.00000
Humibacter	427753	G	15	1	16	0.00000
Diaminobutyricimonas	1433997	G	14	0	14	0.00000
Naasia	1434022	G	14	0	14	0.00000
Gryllotalpicola	1195526	G	12	0	12	0.00000
Aurantimicrobium	1705353	G	12	0	12	0.00000
Pontimonas	1434032	G	10	0	10	0.00000
Rothia	32207	G	1150	22	1172	0.00016
Arthrobacter	1663	G	961	87	1048	0.00014
Pseudarthrobacter	1742993	G	399	32	431	0.00006
Kocuria	57493	G	192	16	208	0.00003
Glutamicibacter	1742989	G	163	9	172	0.00002
Paenarthrobacter	1742992	G	123	41	164	0.00002
Micrococcus	1269	G	83	8	91	0.00001
Sinomonas	596707	G	76	1	77	0.00001
Citricoccus	169133	G	60	3	63	0.00001
Nesterenkonia	57494	G	30	0	30	0.00000
Auritidibacter	1160973	G	22	0	22	0.00000
Psychromicrobium	2078575	G	15	0	15	0.00000
Zhihengliuella	370735	G	10	19	29	0.00000
Cellulomonas	1707	G	416	34	450	0.00006
Paraoerskovia	665568	G	32	2	34	0.00000
Actinotalea	458839	G	22	3	25	0.00000
Oerskovia	162491	G	21	2	23	0.00000
Pseudactinotalea	1926259	G	17	0	17	0.00000
Cellulosimicrobium	157920	G	119	11	130	0.00002
Isoptericola	254250	G	102	32	134	0.00002
Xylanimonas	186188	G	99	7	106	0.00001
Promicromonospora	43676	G	73	2	75	0.00001
Janibacter	53457	G	124	5	129	0.00002
Arsenicicoccus	267408	G	46	2	48	0.00001
Knoellia	136099	G	37	1	38	0.00001
Oryzobacter	1849973	G	33	2	35	0.00000
Terrabacter	53355	G	27	1	28	0.00000
Pedococcus	2805645	G	21	1	22	0.00000
Phycicoccus	367298	G	19	3	22	0.00000
Nostocoides	99479	G	11	0	11	0.00000
Intrasporangium	53357	G	10	0	10	0.00000
Brachybacterium	43668	G	242	12	254	0.00003
Helcobacillus	1161125	G	36	2	38	0.00001
Dermabacter	36739	G	30	1	31	0.00000
Brevibacterium	1696	G	282	17	299	0.00004
Saxibacter	3162691	G	15	0	15	0.00000
Ornithinimicrobium	125287	G	127	5	132	0.00002
Serinicoccus	265976	G	63	5	68	0.00001
Georgenia	154116	G	146	7	153	0.00002
Ruania	626119	G	103	1	104	0.00001
Occultella	2828348	G	17	0	17	0.00000
Dermacoccus	57495	G	23	2	25	0.00000
Yimella	908935	G	18	0	18	0.00000
Luteipulveratus	745364	G	13	0	13	0.00000
Austwickia	1184606	G	26	0	26	0.00000
Gephyromycinifex	2885697	G	19	0	19	0.00000
Dermatophilus	1862	G	16	0	16	0.00000
Sanguibacter	60919	G	56	3	59	0.00001
Demequina	577469	G	50	3	53	0.00001
Luteimicrobium	754249	G	23	2	25	0.00000
Pengzhenrongella	2888818	G	22	1	23	0.00000
Beutenbergia	84756	G	25	0	25	0.00000
Miniimonas	947525	G	18	5	23	0.00000
Kytococcus	57499	G	26	2	28	0.00000
Mycolicibacterium	1866885	G	2154	24	2178	0.00030
Mycobacterium	1763	G	1458	3703	5161	0.00070
Mycobacteroides	670516	G	404	1	405	0.00006
Mycolicibacter	1073531	G	74	0	74	0.00001
Mycolicibacillus	2126281	G	22	0	22	0.00000
Nocardia	1817	G	1341	9	1350	0.00018
Rhodococcus	1827	G	633	11	644	0.00009
Prescottella	2979332	G	87	6	93	0.00001
Rhodococcoides	3259750	G	47	16	63	0.00001
Williamsia	85043	G	13	0	13	0.00000
Corynebacterium	1716	G	1821	24	1845	0.00025
Gordonia	2053	G	408	2	410	0.00006
Dietzia	37914	G	94	0	94	0.00001
Tsukamurella	2060	G	64	0	64	0.00001
Tomitella	741759	G	30	0	30	0.00000
Hoyosella	697025	G	10	0	10	0.00000
Micromonospora	1873	G	1742	95	1837	0.00025
Dactylosporangium	35753	G	676	15	691	0.00009
Actinoplanes	1865	G	609	21	630	0.00009
Plantactinospora	673534	G	89	6	95	0.00001
Solwaraspora	265431	G	72	4	76	0.00001
Phytohabitans	907364	G	71	2	73	0.00001
Catellatospora	53365	G	47	2	49	0.00001
Polymorphospora	338583	G	43	3	46	0.00001
Actinocatenispora	390988	G	28	0	28	0.00000
Couchioplanes	56433	G	24	2	26	0.00000
Longispora	203522	G	15	0	15	0.00000
Salinispora	168694	G	11	0	11	0.00000
Krasilnikovia	349312	G	10	0	10	0.00000
Actinomyces	1654	G	1767	24	1791	0.00024
Schaalia	2529408	G	1040	21	1061	0.00014
Trueperella	1069494	G	200	4	204	0.00003
Gleimia	2692113	G	69	8	77	0.00001
Flaviflexus	1522056	G	51	0	51	0.00001
Arcanobacterium	28263	G	38	0	38	0.00001
Buchananella	2767323	G	24	0	24	0.00000
Pauljensenia	2740557	G	24	0	24	0.00000
Scrofimicrobium	2815785	G	22	0	22	0.00000
Winkia	2692118	G	14	7	21	0.00000
Mobiluncus	2050	G	13	0	13	0.00000
Actinotignum	1653174	G	10	0	10	0.00000
Actinobaculum	76833	G	10	0	10	0.00000
Amycolatopsis	1813	G	1206	26	1232	0.00017
Pseudonocardia	1847	G	330	6	336	0.00005
Saccharopolyspora	1835	G	271	7	278	0.00004
Kutzneria	43356	G	162	4	166	0.00002
Saccharothrix	2071	G	153	11	164	0.00002
Lentzea	165301	G	135	4	139	0.00002
Actinokineospora	39845	G	118	6	124	0.00002
Actinosynnema	40566	G	89	6	95	0.00001
Actinoalloteichus	65496	G	85	1	86	0.00001
Actinomycetospora	402649	G	83	1	84	0.00001
Umezawaea	583360	G	65	2	67	0.00001
Saccharomonospora	1851	G	55	2	57	0.00001
Crossiella	130795	G	42	1	43	0.00001
Allokutzneria	1137960	G	34	1	35	0.00000
Alloactinosynnema	674734	G	25	1	26	0.00000
Prauserella	142577	G	21	0	21	0.00000
Allosaccharopolyspora	2893576	G	14	0	14	0.00000
Kibdelosporangium	2029	G	13	0	13	0.00000
Nocardioides	1839	G	978	24	1002	0.00014
Aeromicrobium	2040	G	142	2	144	0.00002
Pimelobacter	2044	G	35	4	39	0.00001
Mumia	1546255	G	30	0	30	0.00000
Solicola	3024237	G	23	0	23	0.00000
Micropruina	116071	G	14	0	14	0.00000
Friedmanniella	53387	G	12	0	12	0.00000
Propionibacterium	1743	G	339	45	384	0.00005
Tessaracoccus	72763	G	134	3	137	0.00002
Propioniciclava	1085622	G	90	5	95	0.00001
Microlunatus	29404	G	84	0	84	0.00001
Cutibacterium	1912216	G	72	1	73	0.00001
Acidipropionibacterium	1912215	G	70	2	72	0.00001
Raineyella	1911549	G	54	2	56	0.00001
Propionimicrobium	203133	G	33	0	33	0.00000
Brooklawnia	369926	G	31	1	32	0.00000
Ammonicoccus	3417658	G	19	0	19	0.00000
Auraticoccus	1278221	G	18	0	18	0.00000
Arachnia	2801844	G	17	0	17	0.00000
Naumannella	1294511	G	14	0	14	0.00000
Vaginimicrobium	2919589	G	12	0	12	0.00000
Kribbella	182639	G	417	4	421	0.00006
Actinopolymorpha	117156	G	13	0	13	0.00000
Nonomuraea	83681	G	494	14	508	0.00007
Streptosporangium	2000	G	257	7	264	0.00004
Microbispora	2005	G	159	6	165	0.00002
Microtetraspora	1995	G	51	2	53	0.00001
Sphaerisporangium	321315	G	34	0	34	0.00000
Sphaerimonospora	1792303	G	29	1	30	0.00000
Actinomadura	1988	G	337	14	351	0.00005
Spirillospora	58122	G	105	6	111	0.00002
Actinoallomurus	667113	G	91	2	93	0.00001
Thermomonospora	2019	G	60	2	62	0.00001
Nocardiopsis	2013	G	123	4	127	0.00002
Thermobifida	83677	G	61	1	62	0.00001
Streptomonospora	104204	G	31	5	36	0.00000
Spiractinospora	2913367	G	10	0	10	0.00000
Blastococcus	38501	G	113	1	114	0.00002
Geodermatophilus	1860	G	52	0	52	0.00001
Modestobacter	88138	G	24	0	24	0.00000
Frankia	1854	G	90	4	94	0.00001
Parafrankia	2994362	G	37	2	39	0.00001
Pseudofrankia	2994363	G	18	0	18	0.00000
Protofrankia	2994361	G	17	0	17	0.00000
Kineococcus	33981	G	92	1	93	0.00001
Angustibacter	908626	G	16	0	16	0.00000
Nakamurella	53460	G	86	0	86	0.00001
Candidatus Planktophila	622681	G	51	0	51	0.00001
Jiangella	281472	G	59	0	59	0.00001
Stackebrandtia	283810	G	38	0	38	0.00001
Natronoglycomyces	2838311	G	15	0	15	0.00000
Catenulispora	414878	G	33	0	33	0.00000
Jatrophihabitans	1434010	G	20	0	20	0.00000
Actinopolyspora	1849	G	15	0	15	0.00000
Collinsella	102106	G	107535	1809	109344	0.01491
Enorma	1472762	G	167	3	170	0.00002
Coriobacterium	33870	G	23	0	23	0.00000
Parolsenella	2082587	G	428	15	443	0.00006
Olsenella	133925	G	289	22	311	0.00004
Thermophilibacter	2847307	G	213	20	233	0.00003
Parafannyhessea	2847312	G	139	12	151	0.00002
Atopobium	1380	G	109	2	111	0.00002
Lancefieldella	2767353	G	107	1	108	0.00001
Fannyhessea	2767327	G	70	2	72	0.00001
Leptogranulimonas	2995122	G	72	0	72	0.00001
Adlercreutzia	447020	G	14889	380	15269	0.00208
Eggerthella	84111	G	3233	78	3311	0.00045
Gordonibacter	644652	G	1297	42	1339	0.00018
Slackia	84108	G	343	0	343	0.00005
Berryella	2815775	G	185	2	187	0.00003
Raoultibacter	1926677	G	180	0	180	0.00002
Arabiibacter	2005386	G	161	1	162	0.00002
Xiamenia	2981344	G	113	0	113	0.00002
Denitrobacterium	79603	G	90	1	91	0.00001
Cryptobacterium	84162	G	51	0	51	0.00001
Phoenicibacter	1981050	G	50	1	51	0.00001
Iamia	467975	G	42	1	43	0.00001
Aquihabitans	1648491	G	34	1	35	0.00000
Actinomarinicola	2789775	G	28	1	29	0.00000
Dermatobacter	3075137	G	20	0	20	0.00000
Candidatus Poriferisodalis	2983190	G	126	1	127	0.00002
Candidatus Poriferisocius	2983186	G	93	1	94	0.00001
Ilumatobacter	682522	G	36	0	36	0.00000
Salinilacustrithrix	3436875	G	17	0	17	0.00000
Baekduia	2600304	G	60	1	61	0.00001
Svornostia	3231543	G	44	0	44	0.00001
Conexibacter	191494	G	87	1	88	0.00001
Paraconexibacter	2758920	G	72	1	73	0.00001
Capillimicrobium	2976759	G	45	0	45	0.00001
Miltoncostaea	2843200	G	37	0	37	0.00001
Rubrobacter	42255	G	144	0	144	0.00002
Euzebya	908623	G	44	0	44	0.00001
Egicoccus	1755825	G	17	0	17	0.00000
Egibacter	1747770	G	12	0	12	0.00000
Synechococcus	1129	G	507	14	521	0.00007
Prochlorococcus	1218	G	134	2	136	0.00002
Cyanobium	167375	G	83	6	89	0.00001
Synechocystis	1142	G	48	33	81	0.00001
Altericista	2855430	G	20	0	20	0.00000
Nostoc	1177	G	270	0	270	0.00004
Anabaena	1163	G	68	27	95	0.00001
Trichormus	264688	G	40	203	243	0.00003
Dolichospermum	748770	G	28	5	33	0.00000
Sphaerospermopsis	752201	G	21	0	21	0.00000
Okeanomitos	3231549	G	19	0	19	0.00000
Cylindrospermopsis	77021	G	16	0	16	0.00000
Calothrix	1186	G	55	0	55	0.00001
Halotia	1620790	G	10	0	10	0.00000
Brasilonema	383614	G	19	0	19	0.00000
Chlorogloeopsis	1123	G	12	0	12	0.00000
Tolypothrix	111782	G	10	0	10	0.00000
Crocosphaera	263510	G	37	0	37	0.00001
Gloeothece	28070	G	27	0	27	0.00000
Candidatus Atelocyanobacterium	1453359	G	14	0	14	0.00000
Rippkaea	2546365	G	10	0	10	0.00000
Geminocystis	669357	G	53	0	53	0.00001
Picosynechococcus	3079908	G	15	0	15	0.00000
Cyanobacterium	102234	G	13	0	13	0.00000
Gloeocapsopsis	693222	G	29	0	29	0.00000
Gloeocapsa	102231	G	10	0	10	0.00000
Microcystis	1125	G	27	1	28	0.00000
Halothece	76023	G	12	0	12	0.00000
Planktothrix	54304	G	35	0	35	0.00000
Trichodesmium	1205	G	16	0	16	0.00000
Microcoleus	44471	G	11	0	11	0.00000
Phormidium	1198	G	23	0	23	0.00000
Planktothricoides	132607	G	15	0	15	0.00000
Oxynema	1492710	G	12	0	12	0.00000
Capilliphycus	2768926	G	29	0	29	0.00000
Limnospira	2596745	G	25	0	25	0.00000
Leptolyngbya	47251	G	98	1	99	0.00001
Leptothermofonsia	2917830	G	20	0	20	0.00000
Trichothermofontia	3045815	G	21	0	21	0.00000
Trichocoleus	450526	G	19	0	19	0.00000
Thermosynechococcus	146785	G	43	1	44	0.00001
Acaryochloris	155977	G	38	0	38	0.00001
Gloeobacter	33071	G	77	2	79	0.00001
Stanieria	102115	G	41	0	41	0.00001
Pleurocapsa	44474	G	33	0	33	0.00000
Pseudanabaena	1152	G	74	0	74	0.00001
Egbenema	3079668	G	19	0	19	0.00000
Thermoleptolyngbya	2303528	G	17	0	17	0.00000
Thermocoleostomius	3065395	G	16	0	16	0.00000
Chroococcidiopsis	54298	G	37	0	37	0.00001
Moorena	1155738	G	20	0	20	0.00000
Allocoleopsis	2886347	G	13	0	13	0.00000
Halomicronema	170610	G	15	0	15	0.00000
Nodosilinea	1120752	G	12	0	12	0.00000
Chamaesiphon	217161	G	23	0	23	0.00000
Geitlerinema	63132	G	23	0	23	0.00000
Malacoplasma	2791001	G	512	0	512	0.00007
Mycoplasmopsis	2767358	G	182	2	184	0.00003
Mesomycoplasma	2923352	G	70	0	70	0.00001
Metamycoplasma	2895509	G	41	0	41	0.00001
Spiroplasma	2132	G	201	6	207	0.00003
Mesoplasma	46239	G	28	3	31	0.00000
Williamsoniiplasma	2919614	G	10	1	11	0.00000
Mycoplasma	2093	G	183	6	189	0.00003
Acholeplasma	2147	G	44	0	44	0.00001
Candidatus Phytoplasma	33926	G	20	0	20	0.00000
Haploplasma	2903106	G	15	0	15	0.00000
Mariniplasma	2903100	G	12	0	12	0.00000
Hujiaoplasma	3078171	G	11	0	11	0.00000
Dehalogenimonas	670486	G	63	0	63	0.00001
Dehalococcoides	61434	G	51	2	53	0.00001
Roseiflexus	120961	G	41	0	41	0.00001
Chloroflexus	1107	G	23	0	23	0.00000
Candidatus Chlorohelix	3139173	G	24	0	24	0.00000
Pelolinea	1649478	G	44	0	44	0.00001
Anaerolinea	233189	G	30	0	30	0.00000
Candidatus Brevifilum	2019482	G	12	0	12	0.00000
Candidatus Promineifilum	1988031	G	47	0	47	0.00001
Candidatus Leptofilum	3140596	G	25	0	25	0.00000
Tepidiforma	2682228	G	43	0	43	0.00001
Thermoflexus	1495649	G	30	0	30	0.00000
Caldilinea	233191	G	19	0	19	0.00000
Ktedonosporobacter	2692417	G	17	0	17	0.00000
Phototrophicus	2922426	G	13	0	13	0.00000
Capsulimonas	2494209	G	57	0	57	0.00001
Chthonomonas	1077265	G	25	0	25	0.00000
Fimbriimonas	1005038	G	16	0	16	0.00000
Vulcanimicrobium	3016049	G	11	0	11	0.00000
Bacteroides	816	G	1376407	212323	1588730	0.21663
Phocaeicola	909656	G	699420	143791	843211	0.11497
Alistipes	239759	G	332443	41687	374130	0.05101
Acetobacteroides	1647173	G	26	0	26	0.00000
Odoribacter	283168	G	85608	11241	96849	0.01321
Butyricimonas	574697	G	63189	3383	66572	0.00908
Parabacteroides	375288	G	145563	27405	172968	0.02358
Tannerella	195950	G	121	3	124	0.00002
Paraprevotella	577309	G	11148	738	11886	0.00162
Prevotella	838	G	1004	30	1034	0.00014
Segatella	2974251	G	815	22	837	0.00011
Pseudoprevotella	2884814	G	29	0	29	0.00000
Hoylesella	2974257	G	25	2	27	0.00000
Xylanibacter	558436	G	24	0	24	0.00000
Barnesiella	397864	G	795	37	832	0.00011
Coprobacter	1348911	G	447	32	479	0.00007
Muribaculum	1918540	G	326	25	351	0.00005
Paramuribaculum	2518497	G	166	11	177	0.00002
Duncaniella	2518495	G	157	6	163	0.00002
Sodaliphilus	2815786	G	134	3	137	0.00002
Porphyromonas	836	G	624	22	646	0.00009
Dysgonomonas	156973	G	149	1	150	0.00002
Petrimonas	307628	G	82	1	83	0.00001
Proteiniphilum	294702	G	45	0	45	0.00001
Limibacterium	3404873	G	30	0	30	0.00000
Paludibacter	346096	G	42	0	42	0.00001
Candidatus Azobacteroides	511434	G	18	0	18	0.00000
Tenuifilum	2760873	G	18	0	18	0.00000
Salinivirga	1970191	G	12	0	12	0.00000
Draconibacterium	1471399	G	251	5	256	0.00003
Gaoshiqia	3045890	G	80	1	81	0.00001
Maribellus	2678352	G	75	2	77	0.00001
Aquipluma	2792393	G	69	0	69	0.00001
Halosquirtibacter	3374594	G	55	1	56	0.00001
Mangrovibacterium	1573808	G	42	3	45	0.00001
Marinifilum	866673	G	118	1	119	0.00002
Labilibaculum	2060722	G	118	2	120	0.00002
Alkalitalea	1193324	G	42	9	51	0.00001
Xiashengella	3129724	G	24	8	32	0.00000
Flavobacterium	237	G	2661	121	2782	0.00038
Polaribacter	52959	G	388	34	422	0.00006
Flagellimonas	444459	G	279	38	317	0.00004
Tenacibaculum	104267	G	273	25	298	0.00004
Capnocytophaga	1016	G	212	5	217	0.00003
Winogradskyella	286104	G	208	25	233	0.00003
Maribacter	252356	G	184	17	201	0.00003
Aquimarina	290174	G	182	4	186	0.00003
Christiangramia	292691	G	126	7	133	0.00002
Nonlabens	363408	G	115	9	124	0.00002
Formosa	225842	G	106	11	117	0.00002
Myroides	76831	G	96	9	105	0.00001
Aequorivita	153265	G	87	6	93	0.00001
Antarcticibacterium	2058174	G	81	6	87	0.00001
Zunongwangia	417127	G	78	20	98	0.00001
Zobellia	112040	G	76	3	79	0.00001
Cellulophaga	104264	G	69	5	74	0.00001
Flavivirga	1209327	G	67	2	69	0.00001
Algibacter	261827	G	60	9	69	0.00001
Kordia	221065	G	57	1	58	0.00001
Allomuricauda	111500	G	52	4	56	0.00001
Salegentibacter	143222	G	50	22	72	0.00001
Lacinutrix	291183	G	45	6	51	0.00001
Mariniflexile	527198	G	39	5	44	0.00001
Aestuariibaculum	1386924	G	35	2	37	0.00001
Sinomicrobium	1434045	G	33	0	33	0.00000
Leeuwenhoekiella	283735	G	32	7	39	0.00001
Oceanihabitans	2045416	G	32	8	40	0.00001
Lutibacter	358023	G	28	1	29	0.00000
Arenibacter	178469	G	28	3	31	0.00000
Mangrovimonas	1211036	G	28	1	29	0.00000
Dokdonia	326319	G	27	0	27	0.00000
Seonamhaeicola	1649495	G	26	1	27	0.00000
Gillisia	244698	G	26	7	33	0.00000
Hwangdonia	1649460	G	24	3	27	0.00000
Pontimicrobium	2918913	G	24	1	25	0.00000
Amniculibacterium	2715289	G	24	13	37	0.00001
Aureibaculum	2706948	G	24	1	25	0.00000
Olleya	336276	G	24	3	27	0.00000
Zhouia	561555	G	22	2	24	0.00000
Vaginella	1935184	G	22	9	31	0.00000
Salinimicrobium	561367	G	21	0	21	0.00000
Patiriisocius	2822394	G	19	0	19	0.00000
Euzebyella	1287916	G	19	6	25	0.00000
Allotamlana	3400365	G	19	1	20	0.00000
Pukyongia	2831916	G	18	0	18	0.00000
Candidatus Arcticimaribacter	2953860	G	18	1	19	0.00000
Aggregatimonas	2913017	G	17	0	17	0.00000
Psychroserpens	49277	G	17	6	23	0.00000
Psychroflexus	83612	G	17	0	17	0.00000
Constantimarinum	2907134	G	17	0	17	0.00000
Daejeonia	2027867	G	16	6	22	0.00000
Abyssalbus	2967089	G	15	0	15	0.00000
Siansivirga	1204360	G	14	1	15	0.00000
Ulvibacterium	2665910	G	14	0	14	0.00000
Bizionia	283785	G	13	1	14	0.00000
Thalassobellus	3400333	G	12	1	13	0.00000
Galbibacter	379068	G	12	0	12	0.00000
Pseudalgibacter	2861660	G	10	1	11	0.00000
Chryseobacterium	59732	G	1330	74	1404	0.00019
Kaistella	2782231	G	115	5	120	0.00002
Epilithonimonas	2782229	G	40	6	46	0.00001
Elizabethkingia	308865	G	190	15	205	0.00003
Riemerella	34084	G	58	3	61	0.00001
Apibacter	1778601	G	52	0	52	0.00001
Empedobacter	59734	G	45	6	51	0.00001
Ornithobacterium	28250	G	42	1	43	0.00001
Bergeyella	59735	G	29	1	30	0.00000
Cloacibacterium	501783	G	24	6	30	0.00000
Faecalibacter	2766734	G	24	1	25	0.00000
Weeksella	1013	G	16	4	20	0.00000
Blattabacterium	34098	G	148	1	149	0.00002
Fluviicola	332102	G	33	0	33	0.00000
Paracrocinitomix	3024544	G	29	0	29	0.00000
Parvicella	2975260	G	22	0	22	0.00000
Sanyastnella	3228946	G	14	0	14	0.00000
Hymenobacter	89966	G	658	6	664	0.00009
Pontibacter	323449	G	162	3	165	0.00002
Rufibacter	1379908	G	49	2	51	0.00001
Adhaeribacter	299566	G	31	0	31	0.00000
Nibribacter	1649474	G	11	0	11	0.00000
Echinicola	390846	G	213	21	234	0.00003
Algoriphagus	246875	G	141	12	153	0.00002
Cyclobacterium	68288	G	44	4	48	0.00001
Mongoliitalea	1511649	G	30	1	31	0.00000
Aquiflexum	280472	G	17	1	18	0.00000
Dyadobacter	120831	G	198	9	207	0.00003
Runella	105	G	65	1	66	0.00001
Larkinella	332157	G	33	1	34	0.00000
Tellurirhabdus	2674996	G	24	2	26	0.00000
Fibrella	861914	G	22	1	23	0.00000
Spirosoma	107	G	265	3	268	0.00004
Cytophaga	978	G	14	0	14	0.00000
Flammeovirga	59739	G	61	2	63	0.00001
Chondrinema	3051458	G	55	4	59	0.00001
Imperialibacter	1649461	G	31	2	33	0.00000
Reichenbachiella	156993	G	68	2	70	0.00001
Ekhidna	447678	G	41	2	43	0.00001
Fulvivirga	396811	G	73	4	77	0.00001
Chryseolinea	1433993	G	22	2	24	0.00000
Aureibacter	1097443	G	49	1	50	0.00001
Persicobacter	59740	G	34	1	35	0.00000
Fulvitalea	1434007	G	14	0	14	0.00000
Marivirga	869806	G	92	10	102	0.00001
Bernardetia	1937972	G	77	0	77	0.00001
Arcticibacterium	2173039	G	32	0	32	0.00000
Emticicia	312278	G	23	0	23	0.00000
Marinilongibacter	2975149	G	11	0	11	0.00000
Roseivirga	290180	G	58	3	61	0.00001
Catalinimonas	1522128	G	23	0	23	0.00000
Tunicatimonas	1077254	G	16	0	16	0.00000
Rhodocytophaga	455076	G	32	0	32	0.00000
Aquirufa	2676247	G	13	0	13	0.00000
Mangrovivirga	2858886	G	12	0	12	0.00000
Mucilaginibacter	423349	G	669	3	672	0.00009
Sphingobacterium	28453	G	610	17	627	0.00009
Pedobacter	84567	G	601	5	606	0.00008
Olivibacter	376469	G	67	5	72	0.00001
Solitalea	929509	G	34	0	34	0.00000
Arcticibacter	1288026	G	22	0	22	0.00000
Anseongella	1773450	G	21	0	21	0.00000
Pseudopedobacter	1649482	G	15	0	15	0.00000
Aurantibacillus	3088889	G	21	0	21	0.00000
Chitinophaga	79328	G	453	6	459	0.00006
Arachidicoccus	1769012	G	94	1	95	0.00001
Niabella	379899	G	75	1	76	0.00001
Paraflavitalea	2698688	G	57	1	58	0.00001
Sediminibacterium	504481	G	40	0	40	0.00001
Lacibacter	649461	G	36	0	36	0.00000
Flavisolibacter	398041	G	34	0	34	0.00000
Flavihumibacter	1004301	G	24	0	24	0.00000
Puia	2045098	G	24	0	24	0.00000
Ferruginibacter	1004303	G	21	0	21	0.00000
Phnomibacter	2836216	G	19	0	19	0.00000
Niastella	354354	G	15	0	15	0.00000
Filimonas	649460	G	14	0	14	0.00000
Pseudobacter	1860196	G	14	0	14	0.00000
Panacibacter	1874621	G	14	0	14	0.00000
Saprospira	1007	G	31	0	31	0.00000
Aureispira	365032	G	23	0	23	0.00000
Haliscomenobacter	2349	G	25	0	25	0.00000
Phaeodactylibacter	1564515	G	17	0	17	0.00000
Neolewinella	2993541	G	22	0	22	0.00000
Lewinella	70994	G	12	0	12	0.00000
Candidatus Sulfidibacterium	2923290	G	29	0	29	0.00000
Chlorobium	1091	G	76	0	76	0.00001
Pelodictyon	1099	G	37	0	37	0.00001
Prosthecochloris	1101	G	80	0	80	0.00001
Chlorobaculum	256319	G	53	0	53	0.00001
Rhodothermus	29548	G	41	0	41	0.00001
Rhodocaloribacter	2893090	G	28	1	29	0.00000
Rubrivirga	1434037	G	69	2	71	0.00001
Salinibacter	146918	G	41	0	41	0.00001
Ignavibacterium	795750	G	71	0	71	0.00001
Melioribacter	1134403	G	10	0	10	0.00000
Cyclonatronum	2489367	G	28	0	28	0.00000
Gracilimonas	649462	G	27	0	27	0.00000
Gemmatimonas	173479	G	88	0	88	0.00001
Gemmatirosa	1706036	G	53	1	54	0.00001
Pseudogemmatithrix	3237678	G	18	0	18	0.00000
Candidatus Palauibacter	3056650	G	54	0	54	0.00001
Gaopeijia	3381669	G	10	0	10	0.00000
Fibrobacter	832	G	62	0	62	0.00001
Candidatus Cloacimonas	456826	G	14	0	14	0.00000
Fidelibacter	3377528	G	12	0	12	0.00000
Salmonella	590	G	4227	31881	36108	0.00492
Klebsiella	570	G	3119	3038	6157	0.00084
Raoultella	160674	G	76	12	88	0.00001
Enterobacter	547	G	2011	6299	8310	0.00113
Escherichia	561	G	1019	3593	4612	0.00063
Citrobacter	544	G	328	23	351	0.00005
Kosakonia	1330547	G	155	2	157	0.00002
Cronobacter	413496	G	132	2	134	0.00002
Leclercia	83654	G	110	10	120	0.00002
Cedecea	158483	G	91	1	92	0.00001
Pluralibacter	1330546	G	68	1	69	0.00001
Candidatus Blochmanniella	203804	G	20	9	29	0.00000
Symbiopectobacterium	801	G	13	0	13	0.00000
Siccibacter	1649298	G	54	0	54	0.00001
Kluyvera	579	G	48	1	49	0.00001
Buttiauxella	82976	G	38	35	73	0.00001
Jejubacter	2815296	G	33	0	33	0.00000
Superficieibacter	2303321	G	32	0	32	0.00000
Phytobacter	447792	G	30	3	33	0.00000
Franconibacter	1649295	G	29	0	29	0.00000
Lelliottia	1330545	G	27	0	27	0.00000
Plesiomonas	702	G	24	0	24	0.00000
Candidatus Profftia	1177214	G	21	0	21	0.00000
Shimwellia	1335483	G	20	0	20	0.00000
Pseudocitrobacter	1504576	G	17	0	17	0.00000
Atlantibacter	1903434	G	16	0	16	0.00000
Yokenella	158876	G	15	0	15	0.00000
Pseudescherichia	2055880	G	14	0	14	0.00000
Scandinavium	2726810	G	14	0	14	0.00000
Shigella	620	G	10	8	18	0.00000
Serratia	613	G	1821	66	1887	0.00026
Yersinia	629	G	1703	73	1776	0.00024
Rahnella	34037	G	139	2	141	0.00002
Rouxiella	1565532	G	46	0	46	0.00001
Nissabacter	1964366	G	33	0	33	0.00000
Chimaeribacter	2716544	G	19	0	19	0.00000
Gibbsiella	929812	G	17	0	17	0.00000
Chania	1745211	G	17	0	17	0.00000
Ewingella	41201	G	16	0	16	0.00000
Pantoea	53335	G	577	19	596	0.00008
Buchnera	32199	G	347	1	348	0.00005
Erwinia	551	G	283	12	295	0.00004
Mixta	2100764	G	55	6	61	0.00001
Tatumella	82986	G	53	0	53	0.00001
Duffyella	3026546	G	23	2	25	0.00000
Winslowiella	2997349	G	20	1	21	0.00000
Paramixta	3231896	G	12	0	12	0.00000
Proteus	583	G	256	15	271	0.00004
Providencia	586	G	196	30	226	0.00003
Xenorhabdus	626	G	177	1	178	0.00002
Arsenophonus	637	G	152	0	152	0.00002
Morganella	581	G	87	2	89	0.00001
Photorhabdus	29487	G	35	0	35	0.00000
Moellerella	158848	G	10	1	11	0.00000
Pectobacterium	122277	G	285	5	290	0.00004
Dickeya	204037	G	184	2	186	0.00003
Brenneria	71655	G	46	10	56	0.00001
Lonsdalea	1082702	G	26	0	26	0.00000
Edwardsiella	635	G	113	2	115	0.00002
Hafnia	568	G	49	3	52	0.00001
Obesumbacterium	82982	G	10	5	15	0.00000
Sodalis	84565	G	142	0	142	0.00002
Gallaecimonas	745410	G	55	0	55	0.00001
Leminorella	82980	G	23	0	23	0.00000
Pseudomonas	286	G	8635	393	9028	0.00123
Stutzerimonas	2901164	G	308	52	360	0.00005
Halopseudomonas	2901189	G	189	14	203	0.00003
Metapseudomonas	3236656	G	92	14	106	0.00001
Ectopseudomonas	3236654	G	71	40	111	0.00002
Aquipseudomonas	3236652	G	70	17	87	0.00001
Azotobacter	352	G	21	5	26	0.00000
Entomomonas	2758906	G	17	0	17	0.00000
Phytopseudomonas	3236657	G	15	3	18	0.00000
Geopseudomonas	3236655	G	12	2	14	0.00000
Denitrificimonas	2901261	G	11	0	11	0.00000
Thiopseudomonas	1654787	G	10	0	10	0.00000
Marinobacter	2742	G	474	5	479	0.00007
Xanthomonas	338	G	2532	1101	3633	0.00050
Stenotrophomonas	40323	G	855	48	903	0.00012
Lysobacter	68	G	338	3	341	0.00005
Pseudoxanthomonas	83618	G	269	4	273	0.00004
Luteimonas	83614	G	183	1	184	0.00003
Thermomonas	141948	G	46	0	46	0.00001
Marilutibacter	3382698	G	25	0	25	0.00000
Xylella	2370	G	23	0	23	0.00000
Agrilutibacter	3382696	G	23	0	23	0.00000
Solilutibacter	3382695	G	16	0	16	0.00000
Pseudoluteimonas	3382694	G	13	0	13	0.00000
Dyella	231454	G	216	15	231	0.00003
Luteibacter	242605	G	157	6	163	0.00002
Rhodanobacter	75309	G	102	12	114	0.00002
Tahibacter	1453544	G	58	1	59	0.00001
Frateuria	70411	G	43	6	49	0.00001
Dokdonella	323413	G	22	0	22	0.00000
Aerosticca	2707020	G	12	3	15	0.00000
Shewanella	22	G	1207	5	1212	0.00017
Parashewanella	2547964	G	21	0	21	0.00000
Pseudoalteromonas	53246	G	843	3334	4177	0.00057
Psychrosphaera	907197	G	12	0	12	0.00000
Alteromonas	226	G	129	8	137	0.00002
Salinimonas	288793	G	26	2	28	0.00000
Agarivorans	261825	G	47	0	47	0.00001
Paraglaciecola	1621534	G	33	2	35	0.00000
Lacimicrobium	1751872	G	30	1	31	0.00000
Hydrocarboniclastica	2650549	G	20	0	20	0.00000
Alkalimarinus	1858563	G	14	0	14	0.00000
Halioxenophilus	2108524	G	13	0	13	0.00000
Saliniradius	2661818	G	12	0	12	0.00000
Neptunicella	2125985	G	11	0	11	0.00000
Alishewanella	111142	G	11	0	11	0.00000
Catenovulum	1172191	G	10	0	10	0.00000
Colwellia	28228	G	212	1	213	0.00003
Thalassomonas	137583	G	87	0	87	0.00001
Thalassotalea	1518149	G	81	0	81	0.00001
Litorilituus	1407056	G	12	0	12	0.00000
Pseudocolwellia	2848177	G	10	0	10	0.00000
Ferrimonas	44011	G	90	0	90	0.00001
Idiomarina	135575	G	51	0	51	0.00001
Pseudidiomarina	2800384	G	20	0	20	0.00000
Psychromonas	67572	G	48	0	48	0.00001
Moritella	58050	G	44	0	44	0.00001
Motilimonas	1914248	G	16	0	16	0.00000
Haemophilus	724	G	2068	56	2124	0.00029
Actinobacillus	713	G	84	3	87	0.00001
Mannheimia	75984	G	72	1	73	0.00001
Aggregatibacter	416916	G	69	0	69	0.00001
Gallibacterium	155493	G	66	2	68	0.00001
Pasteurella	745	G	57	8	65	0.00001
Lonepinella	53416	G	32	0	32	0.00000
Glaesserella	2094023	G	27	0	27	0.00000
Basfia	697331	G	21	0	21	0.00000
Mergibacter	2899790	G	21	0	21	0.00000
Rodentibacter	1960084	G	19	0	19	0.00000
Avibacterium	292486	G	17	0	17	0.00000
Vespertiliibacter	1520333	G	16	0	16	0.00000
Bibersteinia	476528	G	15	0	15	0.00000
Histophilus	214906	G	15	0	15	0.00000
Halomonas	2745	G	655	32	687	0.00009
Vreelandella	3137766	G	123	146	269	0.00004
Salinicola	404432	G	92	1	93	0.00001
Cobetia	204286	G	35	0	35	0.00000
Kushneria	504090	G	29	0	29	0.00000
Pistricoccus	1897649	G	27	0	27	0.00000
Chromohalobacter	42054	G	24	1	25	0.00000
Zymobacter	33073	G	18	0	18	0.00000
Billgrantia	3137761	G	22	1	23	0.00000
Halotalea	376488	G	19	0	19	0.00000
Neptunomonas	75687	G	330	5	335	0.00005
Marinomonas	28253	G	134	1	135	0.00002
Marinobacterium	48075	G	112	2	114	0.00002
Neptuniibacter	459520	G	86	1	87	0.00001
Thalassolituus	187492	G	62	1	63	0.00001
Nitrincola	267849	G	43	0	43	0.00001
Aliamphritea	3018276	G	37	0	37	0.00001
Amphritea	515417	G	27	0	27	0.00000
Motiliproteus	1775292	G	26	0	26	0.00000
Marinospirillum	64968	G	24	0	24	0.00000
Bermanella	599651	G	15	0	15	0.00000
Bacterioplanes	1537406	G	15	0	15	0.00000
Bacterioplanoides	2066071	G	15	0	15	0.00000
Venatoribacter	2893036	G	12	0	12	0.00000
Alloalcanivorax	3020832	G	67	0	67	0.00001
Alcanivorax	59753	G	51	0	51	0.00001
Isoalcanivorax	3020833	G	11	0	11	0.00000
Hahella	158481	G	80	0	80	0.00001
Allohahella	1855402	G	40	0	40	0.00001
Endozoicomonas	305899	G	83	0	83	0.00001
Gynuella	1445504	G	21	0	21	0.00000
Reinekea	230494	G	19	0	19	0.00000
Oleiphilus	141450	G	18	0	18	0.00000
Pokkaliibacter	2301194	G	13	0	13	0.00000
Vibrio	662	G	1838	48	1886	0.00026
Photobacterium	657	G	189	5	194	0.00003
Aliivibrio	511678	G	47	1	48	0.00001
Grimontia	246861	G	44	0	44	0.00001
Salinivibrio	51366	G	24	0	24	0.00000
Enterovibrio	188143	G	12	0	12	0.00000
Thaumasiovibrio	2014233	G	11	0	11	0.00000
Acinetobacter	469	G	1172	52	1224	0.00017
Psychrobacter	497	G	192	0	192	0.00003
Moraxella	475	G	88	0	88	0.00001
Faucicola	1604696	G	41	0	41	0.00001
Lwoffella	3444169	G	14	0	14	0.00000
Alkanindiges	222991	G	11	0	11	0.00000
Acidihalobacter	1765964	G	292	2	294	0.00004
Ectothiorhodospira	1051	G	74	1	75	0.00001
Spiribacter	1335745	G	70	0	70	0.00001
Thioalkalivibrio	106633	G	59	0	59	0.00001
Halorhodospira	85108	G	19	0	19	0.00000
Alkalilimnicola	133193	G	17	0	17	0.00000
Aquisalimonas	406099	G	12	0	12	0.00000
Thiorhodovibrio	61593	G	75	0	75	0.00001
Nitrosococcus	1227	G	62	0	62	0.00001
Allochromatium	85072	G	59	2	61	0.00001
Thiocapsa	1056	G	38	0	38	0.00001
Thiocystis	13724	G	33	0	33	0.00000
Rheinheimera	67575	G	32	0	32	0.00000
Thioflavicoccus	156885	G	27	0	27	0.00000
Thiodictyon	53392	G	23	0	23	0.00000
Thermochromatium	85073	G	22	0	22	0.00000
Marichromatium	85076	G	14	0	14	0.00000
Candidatus Nitrosacidococcus	2796146	G	11	0	11	0.00000
Candidatus Thiodiazotropha	1913444	G	31	0	31	0.00000
Magnetovirga	3425870	G	31	0	31	0.00000
Thiolapillus	1608298	G	23	0	23	0.00000
Sedimenticola	349742	G	21	0	21	0.00000
Guyparkeria	2035712	G	60	1	61	0.00001
Sulfuriflexus	1860077	G	17	0	17	0.00000
Granulosicoccus	437504	G	16	0	16	0.00000
Halothiobacillus	109262	G	25	0	25	0.00000
Wenzhouxiangella	1676142	G	10	0	10	0.00000
Aeromonas	642	G	915	2650	3565	0.00049
Oceanimonas	129577	G	57	0	57	0.00001
Zobellella	347533	G	33	0	33	0.00000
Pseudaeromonas	1929090	G	19	0	19	0.00000
Dongshaea	2802288	G	12	0	12	0.00000
Tolumonas	43947	G	10	0	10	0.00000
Oceanisphaera	225143	G	10	0	10	0.00000
Succinivibrio	83770	G	63	0	63	0.00001
Microbulbifer	48073	G	312	3	315	0.00004
Teredinibacter	2425	G	93	0	93	0.00001
Cellvibrio	10	G	40	0	40	0.00001
Simiduia	447467	G	20	0	20	0.00000
Maricurvus	1122283	G	15	0	15	0.00000
Gilvimarinus	940550	G	14	0	14	0.00000
Marinimicrobium	359337	G	12	0	12	0.00000
Halioglobus	1217416	G	52	0	52	0.00001
Luminiphilus	1341118	G	20	0	20	0.00000
Congregibacter	393661	G	18	1	19	0.00000
Kineobactrum	2678529	G	15	0	15	0.00000
Spongiibacter	630749	G	25	2	27	0.00000
Methylomonas	416	G	195	0	195	0.00003
Methylococcus	413	G	104	2	106	0.00001
Methylobacter	429	G	49	0	49	0.00001
Methylomicrobium	39773	G	40	0	40	0.00001
Methylovulum	762296	G	40	0	40	0.00001
Methylomagnum	1760987	G	36	0	36	0.00000
Methylocaldum	73778	G	29	0	29	0.00000
Candidatus Methylocalor	3135206	G	22	0	22	0.00000
Candidatus Methylospira	1808977	G	20	0	20	0.00000
Methylogaea	1295378	G	18	0	18	0.00000
Methylotuvimicrobium	2822410	G	18	0	18	0.00000
Methylomarinovum	1486720	G	45	0	45	0.00001
Thiomicrorhabdus	2039723	G	57	0	57	0.00001
Piscirickettsia	1237	G	37	0	37	0.00001
Thiomicrospira	933	G	23	2	25	0.00000
Methylophaga	40222	G	22	0	22	0.00000
Thiosulfativibrio	2781120	G	21	0	21	0.00000
Hydrogenovibrio	28884	G	13	10	23	0.00000
Francisella	262	G	94	0	94	0.00001
Thiothrix	1030	G	80	0	80	0.00001
Legionella	445	G	272	2	274	0.00004
Rickettsiella	59195	G	29	0	29	0.00000
Coxiella	776	G	17	29	46	0.00001
Hydrocarboniphaga	243627	G	42	2	44	0.00001
Solimonas	413435	G	37	1	38	0.00001
Nevskia	64001	G	36	2	38	0.00001
Sinimarinibacterium	1861863	G	20	0	20	0.00000
Algiphilus	1266053	G	26	0	26	0.00000
Candidatus Pseudothioglobus	2841677	G	25	0	25	0.00000
Candidatus Thiodubiliella	2738885	G	21	0	21	0.00000
Candidatus Vesicomyidisocius	2732587	G	16	0	16	0.00000
Candidatus Vondammii	2686004	G	16	12	28	0.00000
Celerinatantimonas	412033	G	24	0	24	0.00000
Candidatus Reidiella	2738850	G	11	0	11	0.00000
Gilliamella	1193503	G	61	0	61	0.00001
Orbus	743714	G	16	0	16	0.00000
Cardiobacterium	2717	G	48	1	49	0.00001
Suttonella	13275	G	16	0	16	0.00000
Ignatzschineria	112008	G	14	0	14	0.00000
Sulfurifustis	1692042	G	42	0	42	0.00001
Sulfuricaulis	1744881	G	16	0	16	0.00000
Acidiferrobacter	986106	G	12	0	12	0.00000
Thiohalobacter	1273155	G	38	0	38	0.00001
Immundisolibacter	1934947	G	32	0	32	0.00000
Kangiella	261963	G	31	0	31	0.00000
Sulfurivermis	2034504	G	26	0	26	0.00000
Candidatus Spongiihabitans	3033996	G	25	0	25	0.00000
Candidatus Portiera	235572	G	23	0	23	0.00000
Woeseia	1738655	G	17	0	17	0.00000
Salinisphaera	180541	G	17	0	17	0.00000
Xanthobacter	279	G	3646	117	3763	0.00051
Ancylobacter	99	G	171	5	176	0.00002
Labrys	204476	G	44	0	44	0.00001
Starkeya	152053	G	34	0	34	0.00000
Aquabacter	45402	G	30	0	30	0.00000
Pseudolabrys	556257	G	24	0	24	0.00000
Azorhizobium	6	G	22	0	22	0.00000
Bartonella	773	G	3736	30	3766	0.00051
Rhizobium	379	G	1331	84	1415	0.00019
Agrobacterium	357	G	519	258	777	0.00011
Neorhizobium	1525371	G	137	47	184	0.00003
Pararhizobium	1612611	G	92	4	96	0.00001
Allorhizobium	78526	G	27	2	29	0.00000
Sinorhizobium	28105	G	254	23	277	0.00004
Ensifer	106591	G	158	9	167	0.00002
Shinella	323620	G	193	36	229	0.00003
Hoeflea	274591	G	106	2	108	0.00001
Georhizobium	2661800	G	27	0	27	0.00000
Liberibacter	34019	G	18	0	18	0.00000
Peteryoungia	2853332	G	17	1	18	0.00000
Aliirhizobium	3070965	G	17	1	18	0.00000
Ciceribacter	1648508	G	11	0	11	0.00000
Lentilitoribacter	1649463	G	11	0	11	0.00000
Bradyrhizobium	374	G	2121	358	2479	0.00034
Rhodopseudomonas	1073	G	203	4	207	0.00003
Tardiphaga	1395974	G	73	1	74	0.00001
Afipia	1033	G	62	5	67	0.00001
Nitrobacter	911	G	22	0	22	0.00000
Mesorhizobium	68287	G	882	43	925	0.00013
Nitratireductor	245876	G	160	6	166	0.00002
Phyllobacterium	28100	G	80	1	81	0.00001
Aminobacter	31988	G	80	14	94	0.00001
Aquibium	2911176	G	46	1	47	0.00001
Terribium	3143704	G	31	2	33	0.00000
Chelativorans	449972	G	24	1	25	0.00000
Methylobacterium	407	G	537	26	563	0.00008
Microvirga	186650	G	183	2	185	0.00003
Methylorubrum	2282523	G	75	13	88	0.00001
Devosia	46913	G	347	5	352	0.00005
Pelagibacterium	1082930	G	83	5	88	0.00001
Paradevosia	1573407	G	37	1	38	0.00001
Maritalea	623276	G	23	0	23	0.00000
Roseibium	150830	G	201	38	239	0.00003
Stappia	152161	G	117	5	122	0.00002
Breoghania	1406135	G	40	0	40	0.00001
Pannonibacter	227873	G	28	6	34	0.00000
Labrenzia	478070	G	17	3	20	0.00000
Pseudovibrio	258255	G	16	0	16	0.00000
Bosea	85413	G	353	6	359	0.00005
Aureimonas	414371	G	159	7	166	0.00002
Martelella	293088	G	93	5	98	0.00001
Antarcticirhabdus	3042730	G	41	2	43	0.00001
Jiella	1775688	G	17	0	17	0.00000
Aurantimonas	182269	G	12	0	12	0.00000
Methylocystis	133	G	162	6	168	0.00002
Methylosinus	425	G	79	5	84	0.00001
Brucella	234	G	156	97	253	0.00003
Pseudochrobactrum	354349	G	50	1	51	0.00001
Hyphomicrobium	81	G	101	2	103	0.00001
Rhodomicrobium	1068	G	36	1	37	0.00001
Methyloceanibacter	1484898	G	22	1	23	0.00000
Rhodoplanes	29407	G	16	0	16	0.00000
Methyloligella	1485594	G	16	0	16	0.00000
Oricola	1594166	G	60	2	62	0.00001
Oceaniradius	2679892	G	32	6	38	0.00001
Roseitalea	1915401	G	19	1	20	0.00000
Ahrensia	152180	G	16	0	16	0.00000
Reyranella	445219	G	117	1	118	0.00002
Pyruvatibacter	1742974	G	39	0	39	0.00001
Kaustia	2838250	G	20	0	20	0.00000
Anderseniella	444432	G	17	0	17	0.00000
Parvibaculum	256616	G	14	1	15	0.00000
Candidatus Phaeomarinobacter	1541445	G	14	0	14	0.00000
Phreatobacter	1632780	G	92	2	94	0.00001
Methylovirgula	1156568	G	46	0	46	0.00001
Methylocella	120652	G	24	0	24	0.00000
Cohaesibacter	655352	G	63	0	63	0.00001
Acuticoccus	1904377	G	62	0	62	0.00001
Pleomorphomonas	261933	G	35	1	36	0.00000
Hartmannibacter	1572860	G	21	0	21	0.00000
Nordella	169055	G	24	0	24	0.00000
Enhydrobacter	212791	G	10	0	10	0.00000
Blastochloris	59282	G	44	1	45	0.00001
Alsobacter	1502180	G	38	1	39	0.00001
Bauldia	1145345	G	22	0	22	0.00000
Kaistia	166953	G	13	0	13	0.00000
Salinarimonas	690086	G	28	1	29	0.00000
Lichenihabitans	2723776	G	27	0	27	0.00000
Aestuariivirga	2650923	G	26	0	26	0.00000
Terrirubrum	3142786	G	24	0	24	0.00000
Chelatococcus	28209	G	19	0	19	0.00000
Rhodoligotrophos	987053	G	19	0	19	0.00000
Chenggangzhangella	2041902	G	19	0	19	0.00000
Coralliovum	3228940	G	15	0	15	0.00000
Salaquimonas	2712688	G	11	0	11	0.00000
Paracoccus	265	G	858	1422	2280	0.00031
Cereibacter	1653176	G	68	1	69	0.00001
Pseudooceanicola	1679449	G	61	0	61	0.00001
Rhodovulum	34008	G	55	0	55	0.00001
Thioclava	285107	G	48	0	48	0.00001
Yoonia	2211641	G	48	0	48	0.00001
Gymnodinialimonas	2937410	G	44	0	44	0.00001
Tabrizicola	1443919	G	41	0	41	0.00001
Pukyongiella	2831925	G	39	1	40	0.00001
Limimaricola	2211638	G	38	0	38	0.00001
Pontivivens	1844015	G	35	0	35	0.00000
Frigidibacter	1775705	G	32	2	34	0.00000
Paroceanicella	2683599	G	31	0	31	0.00000
Tritonibacter	2083206	G	30	0	30	0.00000
Roseinatronobacter	121820	G	27	0	27	0.00000
Polymorphum	991903	G	26	2	28	0.00000
Roseicitreum	1209946	G	26	0	26	0.00000
Pikeienuella	2831955	G	25	0	25	0.00000
Pacificitalea	2846749	G	24	0	24	0.00000
Pseudogemmobacter	2663134	G	23	0	23	0.00000
Profundibacter	2778525	G	23	0	23	0.00000
Pelagovum	2795377	G	22	0	22	0.00000
Pseudoroseicyclus	1813601	G	21	0	21	0.00000
Nioella	1775424	G	19	0	19	0.00000
Falsirhodobacter	1434002	G	19	0	19	0.00000
Arenibacterium	2824249	G	18	0	18	0.00000
Silicimonas	1955420	G	18	0	18	0.00000
Paragemmobacter	3143992	G	17	0	17	0.00000
Marivivens	1759396	G	16	0	16	0.00000
Neotabrizicola	2946607	G	16	0	16	0.00000
Pseudophaeobacter	1541822	G	15	0	15	0.00000
Brevirhabdus	1855413	G	14	0	14	0.00000
Parasedimentitalea	2738399	G	14	0	14	0.00000
Fuscovulum	2818469	G	14	0	14	0.00000
Amaricoccus	56999	G	13	0	13	0.00000
Haematobacter	366614	G	13	1	14	0.00000
Rhodophyticola	2680018	G	12	0	12	0.00000
Gemmobacter	204456	G	12	0	12	0.00000
Fontisubflavum	3118803	G	11	0	11	0.00000
Abyssibius	3029205	G	11	0	11	0.00000
Albidovulum	205889	G	11	0	11	0.00000
Aliiroseovarius	1658781	G	10	0	10	0.00000
Sulfitobacter	60136	G	345	20	365	0.00005
Roseovarius	74030	G	243	9	252	0.00003
Leisingera	191028	G	171	8	179	0.00002
Phaeobacter	302485	G	130	9	139	0.00002
Alloyangia	2919626	G	96	2	98	0.00001
Ruegeria	97050	G	82	2	84	0.00001
Roseivivax	93682	G	68	1	69	0.00001
Thalassovita	335927	G	67	0	67	0.00001
Jannaschia	188905	G	55	0	55	0.00001
Salipiger	263377	G	52	6	58	0.00001
Mameliella	1434019	G	48	1	49	0.00001
Celeribacter	875170	G	45	3	48	0.00001
Ketogulonicigenium	92944	G	42	1	43	0.00001
Roseicyclus	336277	G	42	0	42	0.00001
Tateyamaria	299261	G	33	0	33	0.00000
Pseudosulfitobacter	2854186	G	32	4	36	0.00000
Octadecabacter	53945	G	28	0	28	0.00000
Sagittula	58842	G	27	1	28	0.00000
Marinovum	367771	G	26	1	27	0.00000
Shimia	573139	G	26	0	26	0.00000
Ponticoccus	983507	G	25	0	25	0.00000
Palleronia	315422	G	25	0	25	0.00000
Roseobacter	2433	G	25	0	25	0.00000
Loktanella	245186	G	24	0	24	0.00000
Antarctobacter	74032	G	21	0	21	0.00000
Falsihalocynthiibacter	2854182	G	20	0	20	0.00000
Seohaeicola	481178	G	17	0	17	0.00000
Pelagimonas	1434029	G	16	0	16	0.00000
Tropicibacter	599653	G	15	0	15	0.00000
Thalassococcus	436357	G	12	0	12	0.00000
Oceanicola	252301	G	11	0	11	0.00000
Nereida	282198	G	10	0	10	0.00000
Rhodobacter	1060	G	75	1	76	0.00001
Sphingomonas	13687	G	1082	46	1128	0.00015
Sphingobium	165695	G	540	91	631	0.00009
Novosphingobium	165696	G	423	24	447	0.00006
Sphingopyxis	165697	G	291	20	311	0.00004
Sphingorhabdus	1434046	G	76	0	76	0.00001
Blastomonas	150203	G	75	4	79	0.00001
Rhizorhabdus	1649486	G	57	10	67	0.00001
Sphingomicrobium	1227948	G	42	1	43	0.00001
Parasphingorhabdus	2709685	G	36	0	36	0.00000
Hankyongella	1763827	G	31	1	32	0.00000
Sphingosinithalassobacter	2676233	G	30	2	32	0.00000
Novosphingopyxis	2709686	G	19	3	22	0.00000
Alterisphingorhabdus (ex Yan et al. 2024)	3382518	G	16	0	16	0.00000
Allosphingosinicella	2823232	G	14	0	14	0.00000
Stakelama	1124625	G	12	0	12	0.00000
Erythrobacter	1041	G	169	12	181	0.00002
Porphyrobacter	1111	G	59	6	65	0.00001
Qipengyuania	1855416	G	175	17	192	0.00003
Altererythrobacter	361177	G	67	4	71	0.00001
Croceibacterium	2676755	G	65	3	68	0.00001
Croceicoccus	1295327	G	46	13	59	0.00001
Pelagerythrobacter	2800685	G	43	3	46	0.00001
Tsuneonella	2800686	G	35	2	37	0.00001
Aurantiacibacter	2800681	G	34	2	36	0.00000
Caenibius	2827482	G	20	1	21	0.00000
Paraurantiacibacter	2800682	G	14	0	14	0.00000
Alteriqipengyuania	2800680	G	13	0	13	0.00000
Polymorphobacter	1508451	G	54	0	54	0.00001
Sphingosinicella	335405	G	43	3	46	0.00001
Sandaracinobacteroides	2883109	G	25	0	25	0.00000
Glacieibacterium	2860235	G	19	0	19	0.00000
Zymomonas	541	G	125	13	138	0.00002
Alterirhizorhabdus	3423723	G	13	0	13	0.00000
Azospirillum	191	G	554	11	565	0.00008
Skermanella	204447	G	100	4	104	0.00001
Nitrospirillum	1543705	G	79	1	80	0.00001
Niveispirillum	1543704	G	28	1	29	0.00000
Indioceanicola	2478349	G	24	0	24	0.00000
Magnetospirillum	13134	G	92	10	102	0.00001
Ferrovibrio	1231242	G	77	0	77	0.00001
Rhodospirillum	1081	G	53	1	54	0.00001
Algihabitans	2821512	G	51	0	51	0.00001
Aerophototrophica	2811387	G	30	0	30	0.00000
Hwanghaeella	2605940	G	25	0	25	0.00000
Pararhodospirillum	1612157	G	14	0	14	0.00000
Thalassospira	168934	G	216	2	218	0.00003
Magnetospira	1182780	G	36	0	36	0.00000
Hypericibacter	2705399	G	58	0	58	0.00001
Thalassobaculum	526215	G	33	0	33	0.00000
Nisaea	390876	G	23	0	23	0.00000
Caenispirillum	414051	G	37	0	37	0.00001
Aestuariispira	1647175	G	43	0	43	0.00001
Pelagibius	643951	G	42	0	42	0.00001
Stella	93	G	37	0	37	0.00001
Terasakiella	196080	G	30	0	30	0.00000
Paramagnetospirillum	3031148	G	13	4	17	0.00000
Komagataeibacter	1434011	G	422	23	445	0.00006
Acetobacter	434	G	146	5	151	0.00002
Gluconobacter	441	G	82	2	84	0.00001
Rhodovastum	504465	G	37	0	37	0.00001
Lichenicola	2804525	G	36	0	36	0.00000
Rhodopila	1070	G	32	0	32	0.00000
Granulibacter	364409	G	31	0	31	0.00000
Lichenicoccus	2781897	G	26	0	26	0.00000
Candidatus Kirkpatrickella	3097638	G	24	0	24	0.00000
Gluconacetobacter	89583	G	24	0	24	0.00000
Pararoseomonas	2870712	G	19	2	21	0.00000
Asaia	91914	G	17	1	18	0.00000
Acidibrevibacterium	2603324	G	15	0	15	0.00000
Nguyenibacter	1519186	G	14	0	14	0.00000
Kozakia	153497	G	13	0	13	0.00000
Entomobacter	2811380	G	11	0	11	0.00000
Neoasaia	320496	G	10	0	10	0.00000
Roseomonas	125216	G	322	19	341	0.00005
Sediminicoccus	1706033	G	53	1	54	0.00001
Muricoccus	3409995	G	38	0	38	0.00001
Dankookia	1940143	G	33	0	33	0.00000
Roseococcus	35812	G	24	0	24	0.00000
Humitalea	1223303	G	23	0	23	0.00000
Acidocella	50709	G	36	0	36	0.00000
Acidiphilium	522	G	17	0	17	0.00000
Elioraea	457933	G	25	0	25	0.00000
Brevundimonas	41275	G	456	19	475	0.00006
Caulobacter	75	G	321	15	336	0.00005
Phenylobacterium	20	G	116	6	122	0.00002
Asticcacaulis	76890	G	96	2	98	0.00001
Rickettsia	780	G	87	3	90	0.00001
Candidatus Tisiphia	2996317	G	36	13	49	0.00001
Orientia	69474	G	12	0	12	0.00000
Candidatus Megaera	1742636	G	16	0	16	0.00000
Candidatus Phycorickettsia	2115980	G	16	0	16	0.00000
Wolbachia	953	G	89	5	94	0.00001
Ehrlichia	943	G	27	3	30	0.00000
Glycocaulis	1433402	G	39	3	42	0.00001
Hyphobacterium	2004661	G	38	3	41	0.00001
Oceanicaulis	153232	G	22	2	24	0.00000
Maricaulis	74317	G	18	1	19	0.00000
Litorimonas	1167830	G	20	0	20	0.00000
Fretibacter	1649331	G	11	1	12	0.00000
Tistrella	171436	G	137	7	144	0.00002
Hyphomonas	85	G	93	1	94	0.00001
Candidatus Viadribacter	2892997	G	11	0	11	0.00000
Candidatus Pelagibacter	198251	G	85	0	85	0.00001
Parvularcula	208215	G	27	0	27	0.00000
Aquisalinus	1795639	G	26	0	26	0.00000
Hyphococcus	2038635	G	20	0	20	0.00000
Paremcibacter	2813804	G	36	0	36	0.00000
Emcibacter	1602338	G	20	0	20	0.00000
Luteithermobacter	2813803	G	10	0	10	0.00000
Kordiimonas	288021	G	53	0	53	0.00001
Minwuia	2493629	G	49	0	49	0.00001
Sneathiella	510690	G	41	9	50	0.00001
Candidatus Puniceispirillum	767891	G	20	1	21	0.00000
Burkholderia	32008	G	4148	4637	8785	0.00120
Cupriavidus	106589	G	1457	32	1489	0.00020
Paraburkholderia	1822464	G	896	3	899	0.00012
Ralstonia	48736	G	460	6	466	0.00006
Pandoraea	93217	G	363	4	367	0.00005
Polynucleobacter	44013	G	335	0	335	0.00005
Caballeronia	1827195	G	243	1	244	0.00003
Trinickia	2571160	G	51	0	51	0.00001
Robbsia	2038280	G	46	0	46	0.00001
Lautropia	47670	G	42	0	42	0.00001
Limnobacter	131079	G	36	0	36	0.00000
Pararobbsia	2718863	G	31	0	31	0.00000
Mycetohabitans	2571159	G	28	0	28	0.00000
Mycoavidus	1810868	G	20	0	20	0.00000
Candidatus Vallotiella	2018044	G	19	0	19	0.00000
Imbroritus	3422601	G	19	0	19	0.00000
Sutterella	40544	G	3946	100	4046	0.00055
Duodenibacillus	1980697	G	450	10	460	0.00006
Turicimonas	1918598	G	216	4	220	0.00003
Variovorax	34072	G	978	48	1026	0.00014
Comamonas	283	G	505	41	546	0.00007
Acidovorax	12916	G	375	66	441	0.00006
Hydrogenophaga	47420	G	274	26	300	0.00004
Rhodoferax	28065	G	229	18	247	0.00003
Polaromonas	52972	G	180	2	182	0.00002
Delftia	80865	G	147	49	196	0.00003
Ottowia	219181	G	131	8	139	0.00002
Diaphorobacter	238749	G	110	30	140	0.00002
Limnohabitans	665874	G	97	2	99	0.00001
Ramlibacter	174951	G	83	5	88	0.00001
Paracidovorax	3051137	G	49	31	80	0.00001
Alicycliphilus	201096	G	46	24	70	0.00001
Verminephrobacter	364316	G	31	1	32	0.00000
Melaminivora	1649468	G	28	5	33	0.00000
Paenacidovorax	3051138	G	27	6	33	0.00000
Hylemonella	232523	G	16	0	16	0.00000
Vandammella	2919468	G	15	0	15	0.00000
Brachymonas	28219	G	14	0	14	0.00000
Serpentinimonas	2490452	G	13	0	13	0.00000
Massilia	149698	G	536	61	597	0.00008
Pseudoduganella	1522432	G	293	36	329	0.00004
Duganella	75654	G	88	9	97	0.00001
Telluria	34069	G	51	22	73	0.00001
Rugamonas	212744	G	33	6	39	0.00001
Oxalobacter	846	G	960	11	971	0.00013
Herbaspirillum	963	G	281	11	292	0.00004
Janthinobacterium	29580	G	219	17	236	0.00003
Collimonas	202907	G	75	2	77	0.00001
Undibacterium	401469	G	67	0	67	0.00001
Noviherbaspirillum	1344552	G	41	1	42	0.00001
Achromobacter	222	G	555	42	597	0.00008
Bordetella	517	G	448	38	486	0.00007
Alcaligenes	507	G	136	3	139	0.00002
Pigmentiphaga	152267	G	97	3	100	0.00001
Taylorella	29574	G	93	0	93	0.00001
Castellaniella	359336	G	76	4	80	0.00001
Orrella	1921582	G	50	3	53	0.00001
Paralcaligenes	1148163	G	41	0	41	0.00001
Advenella	290425	G	35	1	36	0.00000
Neopusillimonas	2987605	G	34	2	36	0.00000
Kerstersia	257820	G	30	1	31	0.00000
Oligella	90243	G	27	0	27	0.00000
Pollutimonas	2987599	G	26	4	30	0.00000
Pusillimonas	305976	G	25	1	26	0.00000
Paenalcaligenes	1100891	G	20	0	20	0.00000
Pelistega	106146	G	20	0	20	0.00000
Basilea	1472344	G	14	0	14	0.00000
Roseateles	93681	G	394	9	403	0.00005
Rubrivivax	28067	G	100	6	106	0.00001
Piscinibacter	1114981	G	80	2	82	0.00001
Caldimonas	196013	G	71	4	75	0.00001
Methylibium	316612	G	70	3	73	0.00001
Sphaerotilus	34102	G	64	5	69	0.00001
Leptothrix	88	G	39	2	41	0.00001
Inhella	644355	G	36	1	37	0.00001
Aquincola	391952	G	26	3	29	0.00000
Thiomonas	32012	G	76	0	76	0.00001
Xylophilus	54066	G	69	0	69	0.00001
Tepidimonas	114248	G	58	3	61	0.00001
Piscinibacterium	2066914	G	50	0	50	0.00001
Aquabacterium	92793	G	45	0	45	0.00001
Eleftheria	1597779	G	28	0	28	0.00000
Rhizobacter	212743	G	25	0	25	0.00000
Neisseria	482	G	526	37	563	0.00008
Kingella	32257	G	69	5	74	0.00001
Vitreoscilla	59	G	48	1	49	0.00001
Uruburuella	299568	G	42	1	43	0.00001
Snodgrassella	1193515	G	40	0	40	0.00001
Conchiformibius	334107	G	39	0	39	0.00001
Eikenella	538	G	32	3	35	0.00000
Paralysiella	2898489	G	30	0	30	0.00000
Crenobacter	1654931	G	13	1	14	0.00000
Morococcus	212742	G	11	30	41	0.00001
Chromobacterium	535	G	246	19	265	0.00004
Aquitalea	407217	G	111	11	122	0.00002
Paludibacterium	400060	G	84	3	87	0.00001
Vogesella	57739	G	57	4	61	0.00001
Pseudogulbenkiania	568394	G	17	2	19	0.00000
Iodobacter	32014	G	54	1	55	0.00001
Chitinibacter	230666	G	54	1	55	0.00001
Chitinimonas	240411	G	43	1	44	0.00001
Chitiniphilus	585890	G	36	1	37	0.00001
Jeongeupia	885864	G	36	1	37	0.00001
Deefgea	400947	G	30	0	30	0.00000
Silvimonas	300264	G	24	0	24	0.00000
Chitinolyticbacter	1055692	G	16	0	16	0.00000
Microvirgula	57479	G	32	1	33	0.00000
Laribacter	168470	G	27	2	29	0.00000
Aquaspirillum	187	G	23	0	23	0.00000
Thauera	33057	G	220	21	241	0.00003
Azoarcus	12960	G	103	13	116	0.00002
Nitrogeniibacter	2891294	G	50	0	50	0.00001
Parazoarcus	2891322	G	25	1	26	0.00000
Pseudothauera	2891324	G	16	0	16	0.00000
Pseudazoarcus	2891323	G	10	0	10	0.00000
Dechloromonas	73029	G	193	34	227	0.00003
Ferribacterium	88875	G	33	1	34	0.00000
Azonexus	146936	G	28	8	36	0.00000
Quatrionicoccus	138117	G	17	2	19	0.00000
Azospira	146937	G	125	13	138	0.00002
Niveibacterium	1769726	G	67	0	67	0.00001
Aromatoleum	551759	G	64	8	72	0.00001
Oryzomicrobium	1911577	G	33	1	34	0.00000
Denitratisoma	311181	G	52	3	55	0.00001
Methyloversatilis	378210	G	48	1	49	0.00001
Sulfuricystis	3050898	G	21	1	22	0.00000
Sterolibacterium	157591	G	18	0	18	0.00000
Sulfuritalea	1054211	G	14	0	14	0.00000
Sideroxydans	314343	G	70	1	71	0.00001
Sideroxyarcus	2943286	G	28	0	28	0.00000
Ferrigenium	2249462	G	18	0	18	0.00000
Candidatus Nitrotoga	453161	G	12	0	12	0.00000
Gallionella	96	G	10	0	10	0.00000
Candidatus Methylopumilus	1679002	G	55	0	55	0.00001
Methylobacillus	404	G	31	1	32	0.00000
Methylovorus	81682	G	12	0	12	0.00000
Sulfuriferula	1778653	G	59	1	60	0.00001
Sulfurimicrobium	2772198	G	30	0	30	0.00000
Sulfuricella	935200	G	15	0	15	0.00000
Thiobacillus	919	G	57	5	62	0.00001
Sulfuritortus	1938335	G	23	5	28	0.00000
Nitrosomonas	914	G	49	0	49	0.00001
Nitrosospira	35798	G	30	0	30	0.00000
Usitatibacter	2803845	G	43	0	43	0.00001
Casimicrobium	2706000	G	25	0	25	0.00000
Chitinivorax	1433992	G	18	0	18	0.00000
Candidatus Kinetoplastidibacterium	33055	G	17	0	17	0.00000
Candidatus Accumulibacter	327159	G	14	0	14	0.00000
Ferrovum	416212	G	12	0	12	0.00000
Acidithiobacillus	119977	G	157	0	157	0.00002
Thermithiobacillus	119979	G	18	0	18	0.00000
Mariprofundus	377315	G	24	0	24	0.00000
Akkermansia	239934	G	106641	322	106963	0.01458
Luteolibacter	518753	G	149	0	149	0.00002
Verrucomicrobium	2735	G	96	0	96	0.00001
Roseimicrobium	1348508	G	21	0	21	0.00000
Haloferula	574899	G	15	0	15	0.00000
Fontisphaera	3050007	G	19	0	19	0.00000
Opitutus	178440	G	73	4	77	0.00001
Nibricoccus	2576890	G	33	2	35	0.00000
Termitidicoccus	3126963	G	33	0	33	0.00000
Oleiharenicola	2100741	G	30	3	33	0.00000
Lacunisphaera	1961799	G	28	2	30	0.00000
Synoicihabitans	2892920	G	28	0	28	0.00000
Horticoccus	2986286	G	23	0	23	0.00000
Actomonas	3138693	G	22	0	22	0.00000
Ereboglobus	2028344	G	18	0	18	0.00000
Ruficoccus	2175957	G	25	0	25	0.00000
Rubellicoccus	3138622	G	17	0	17	0.00000
Coraliomargarita	442430	G	41	0	41	0.00001
Methylacidiphilum (ex Ratnadevi et al. 2023)	511745	G	25	0	25	0.00000
Methylacidimicrobium	1541670	G	19	0	19	0.00000
Candidatus Xiphinematobacter	134550	G	10	0	10	0.00000
Stieleria	2795973	G	89	4	93	0.00001
Rosistilla	2795779	G	34	1	35	0.00000
Rhodopirellula	265488	G	33	1	34	0.00000
Roseimaritima	1579506	G	31	0	31	0.00000
Anatilimnocola	2807414	G	30	0	30	0.00000
Bremerella	2714594	G	24	0	24	0.00000
Aureliella	2795605	G	24	0	24	0.00000
Blastopirellula	265487	G	20	0	20	0.00000
Lacipirellula	2691417	G	61	0	61	0.00001
Pirellulimonas	2795783	G	45	0	45	0.00001
Botrimarina	2795782	G	25	0	25	0.00000
Aeoliella	2795781	G	13	0	13	0.00000
Gimesia	1649453	G	116	0	116	0.00002
Schlesneria	656899	G	32	0	32	0.00000
Maioricimonas	2795777	G	31	0	31	0.00000
Planctomyces	118	G	30	3	33	0.00000
Planctellipticum	3132181	G	28	0	28	0.00000
Stratiformator	3076095	G	26	0	26	0.00000
Symmachiella	2795780	G	22	0	22	0.00000
Caulifigura	2795778	G	21	0	21	0.00000
Alienimonas	2714737	G	16	0	16	0.00000
Thalassoglobus	2795865	G	16	0	16	0.00000
Fuerstiella	1936111	G	15	0	15	0.00000
Crateriforma	2714592	G	15	1	16	0.00000
Polystyrenella	2795774	G	10	0	10	0.00000
Singulisphaera	466152	G	96	6	102	0.00001
Tundrisphaera	2029859	G	52	3	55	0.00001
Aquisphaera	1511635	G	38	2	40	0.00001
Tautonia	2680020	G	35	0	35	0.00000
Isosphaera	127	G	19	0	19	0.00000
Paludisphaera	1763521	G	19	1	20	0.00000
Gemmata	113	G	64	0	64	0.00001
Urbifossiella	2807415	G	58	0	58	0.00001
Frigoriglobus	2774146	G	33	0	33	0.00000
Limnoglobus	2731450	G	19	0	19	0.00000
Telmatocola	1382832	G	15	0	15	0.00000
Rohdeia	3405237	G	30	0	30	0.00000
Engelhardtia	3405233	G	24	0	24	0.00000
Saltatorellus	3405235	G	10	0	10	0.00000
Anaerohalosphaera	2690159	G	59	0	59	0.00001
Limihaloglobus	2690160	G	31	0	31	0.00000
Sedimentisphaera	2483368	G	17	0	17	0.00000
Phycisphaera	666508	G	31	0	31	0.00000
Mucisphaera	2913022	G	29	0	29	0.00000
Poriferisphaera	2803301	G	25	0	25	0.00000
Humisphaera	2807511	G	21	0	21	0.00000
Fontivita	2989683	G	13	0	13	0.00000
Candidatus Uabimicrobium	2897349	G	21	0	21	0.00000
Candidatus Kuenenia	380738	G	11	0	11	0.00000
Candidatus Protochlamydia	282132	G	22	0	22	0.00000
Parachlamydia	83551	G	12	0	12	0.00000
Simkania	34093	G	19	0	19	0.00000
Candidatus Rhabdochlamydia	292833	G	12	5	17	0.00000
Chlamydia	810	G	35	0	35	0.00000
Kiritimatiella	1921784	G	31	0	31	0.00000
Tichowtungia	2907187	G	23	0	23	0.00000
Candidatus Velamenicoccus	2789201	G	38	0	38	0.00001
Lentisphaera	256846	G	15	0	15	0.00000
Bilophila	35832	G	8074	131	8205	0.00112
Desulfovibrio	872	G	3547	300	3847	0.00052
Pseudodesulfovibrio	2035811	G	868	74	942	0.00013
Nitratidesulfovibrio	2802295	G	377	12	389	0.00005
Mailhella	1981028	G	371	96	467	0.00006
Maridesulfovibrio	2794998	G	349	9	358	0.00005
Solidesulfovibrio	2910984	G	265	6	271	0.00004
Megalodesulfovibrio	2910978	G	133	1	134	0.00002
Oceanidesulfovibrio	2905722	G	128	1	129	0.00002
Salidesulfovibrio	2950010	G	104	7	111	0.00002
Desulfolutivibrio	2773294	G	88	3	91	0.00001
Taurinivorans	3126915	G	86	2	88	0.00001
Oleidesulfovibrio	2909705	G	83	47	130	0.00002
Desulfocurvibacter	2582840	G	62	1	63	0.00001
Desulfobaculum	1433996	G	44	0	44	0.00001
Halodesulfovibrio	1912771	G	36	1	37	0.00001
Desulfomicrobium	898	G	173	11	184	0.00003
Thermodesulfomicrobium	2905949	G	52	3	55	0.00001
Desulfohalobium	45662	G	23	0	23	0.00000
Geobacter	28231	G	229	10	239	0.00003
Geomonas	2651583	G	125	13	138	0.00002
Geotalea	2910589	G	89	3	92	0.00001
Trichlorobacter	115782	G	81	5	86	0.00001
Citrifermentans	2883512	G	49	9	58	0.00001
Desulfuromonas	890	G	280	5	285	0.00004
Pelobacter	18	G	32	3	35	0.00000
Syntrophotalea	2812025	G	93	1	94	0.00001
Geoalkalibacter	392332	G	59	6	65	0.00001
Desulfosarcina	2299	G	209	3	212	0.00003
Desulfonema	45654	G	55	0	55	0.00001
Desulfococcus	896	G	20	0	20	0.00000
Desulfobacter	2289	G	48	0	48	0.00001
Desulforapulum	2904687	G	14	0	14	0.00000
Desulfobacula	28222	G	10	0	10	0.00000
Desulfatibacillum	218207	G	23	0	23	0.00000
Desulfosudis	2904716	G	18	0	18	0.00000
Desulfoluna	497721	G	16	0	16	0.00000
Desulfobulbus	893	G	84	4	88	0.00001
Desulfolithobacter	3003266	G	49	1	50	0.00001
Desulfomarina	2894767	G	27	0	27	0.00000
Desulfurivibrio	427922	G	18	0	18	0.00000
Candidatus Electrothrix	1859128	G	11	0	11	0.00000
Desulfosediminicola	2886823	G	52	0	52	0.00001
Desulfofustis	51194	G	17	0	17	0.00000
Syntrophobacter	29526	G	45	4	49	0.00001
Desulfoglaeba	361106	G	23	0	23	0.00000
Desulfoferula	3093638	G	35	0	35	0.00000
Desulfarculus	453229	G	32	6	38	0.00001
Syntrophus	43773	G	39	0	39	0.00001
Caldimicrobium	444090	G	15	0	15	0.00000
Thermosulfurimonas	1522431	G	10	0	10	0.00000
Candidatus Desulfofervidus	1902583	G	23	0	23	0.00000
Campylobacter	194	G	3195	24	3219	0.00044
Aliarcobacter	2321111	G	197	15	212	0.00003
Arcobacter	28196	G	120	5	125	0.00002
Malaciobacter	2321114	G	63	1	64	0.00001
Halarcobacter	2321115	G	61	1	62	0.00001
Helicobacter	209	G	354	5	359	0.00005
Sulfurimonas	202746	G	201	1	202	0.00003
Sulfurospirillum	57665	G	100	0	100	0.00001
Sulfurovum	265570	G	54	0	54	0.00001
Hydrogenimonas	223785	G	38	0	38	0.00001
Nitratiruptor	269258	G	57	0	57	0.00001
Nitrosophilus	2795692	G	21	0	21	0.00000
Nautilia	191291	G	17	0	17	0.00000
Caminibacter	191301	G	14	0	14	0.00000
Hippea	84404	G	11	0	11	0.00000
Treponema	157	G	1931	11	1942	0.00026
Brucepastera	2967962	G	50	0	50	0.00001
Sediminispirochaeta	1911556	G	40	0	40	0.00001
Marispirochaeta	1911565	G	35	0	35	0.00000
Spirochaeta	146	G	33	0	33	0.00000
Oceanispirochaeta	2035349	G	30	0	30	0.00000
Salinispira	1616789	G	27	0	27	0.00000
Thiospirochaeta	2792240	G	13	0	13	0.00000
Borreliella	64895	G	97	3	100	0.00001
Borrelia	138	G	56	0	56	0.00001
Sphaerochaeta	399320	G	90	0	90	0.00001
Parasphaerochaeta	3062336	G	35	0	35	0.00000
Breznakiella	2845254	G	58	0	58	0.00001
Leadbettera	2951107	G	41	0	41	0.00001
Gracilinema	2951106	G	26	0	26	0.00000
Leptospira	171	G	219	0	219	0.00003
Turneriella	338321	G	16	0	16	0.00000
Brachyspira	29521	G	168	0	168	0.00002
Myxococcus	32	G	238	46	284	0.00004
Corallococcus	83461	G	152	19	171	0.00002
Pseudomyxococcus	3434272	G	46	16	62	0.00001
Pyxidicoccus	224458	G	34	3	37	0.00001
Archangium	47	G	261	16	277	0.00004
Cystobacter	42	G	106	20	126	0.00002
Melittangium	44	G	59	7	66	0.00001
Stigmatella	40	G	44	3	47	0.00001
Anaeromyxobacter	161492	G	231	3	234	0.00003
Vulgatibacter	1524214	G	48	0	48	0.00001
Pendulispora	3375062	G	126	2	128	0.00002
Sorangium	39643	G	249	5	254	0.00003
Polyangium	55	G	40	1	41	0.00001
Chondromyces	50	G	16	0	16	0.00000
Sandaracinus	1055688	G	64	0	64	0.00001
Labilithrix	1524217	G	34	0	34	0.00000
Nannocystis	53	G	70	0	70	0.00001
Haliangium	162027	G	69	0	69	0.00001
Tunturiibacter	3154218	G	133	6	139	0.00002
Telmatobacter	1078829	G	101	2	103	0.00001
Terriglobus	392733	G	75	2	77	0.00001
Chloracidobacterium	458032	G	49	0	49	0.00001
Granulicella	940557	G	49	2	51	0.00001
Edaphobacter	388463	G	48	1	49	0.00001
Occallatibacter	1742983	G	15	0	15	0.00000
Acidisarcina	2608728	G	13	1	14	0.00000
Acidobacterium	33973	G	12	0	12	0.00000
Candidatus Korobacter	658061	G	19	0	19	0.00000
Paludibaculum	1649475	G	53	0	53	0.00001
Geothrix	44675	G	170	10	180	0.00002
Mesoterricola	3074468	G	67	8	75	0.00001
Sulfidibacter	2915177	G	25	0	25	0.00000
Thermotomaculum	1172428	G	14	0	14	0.00000
Luteitalea	2004797	G	48	4	52	0.00001
Bdellovibrio	958	G	208	0	208	0.00003
Micavibrio	213485	G	32	0	32	0.00000
Pseudobdellovibrio	2862745	G	12	0	12	0.00000
Fluviispira	2698753	G	25	0	25	0.00000
Silvanigrella	2024975	G	18	0	18	0.00000
Spirobacillus	495819	G	11	0	11	0.00000
Halobacteriovorax	1652133	G	42	0	42	0.00001
Nitrospira	1234	G	109	0	109	0.00001
Leptospirillum	179	G	26	0	26	0.00000
Thermodesulfovibrio	28261	G	25	0	25	0.00000
Geovibrio	46200	G	32	0	32	0.00000
Denitrovibrio	117999	G	21	0	21	0.00000
Deferribacter	53572	G	18	0	18	0.00000
Mucispirillum	248038	G	12	0	12	0.00000
Flexistipes	2351	G	12	0	12	0.00000
Elusimicrobium	423604	G	56	1	57	0.00001
Endomicrobium	1408194	G	30	0	30	0.00000
Aquifex	2713	G	12	0	12	0.00000
Persephonella	182899	G	17	0	17	0.00000
Sulfurihydrogenibium	212790	G	11	0	11	0.00000
Atrimonas	3149264	G	21	9	30	0.00000
Candidatus Caldatribacterium	1454725	G	20	0	20	0.00000
Atribacter	2847777	G	15	0	15	0.00000
Nitrospina	35800	G	48	0	48	0.00001
Caldithrix	187144	G	47	0	47	0.00001
Dictyoglomus	13	G	39	0	39	0.00001
Sphaerobacter	2056	G	20	0	20	0.00000
Thermomicrobium	499	G	17	0	17	0.00000
Desulfurispirillum	393029	G	13	0	13	0.00000
Thermosulfidibacter	412592	G	10	0	10	0.00000
Deinococcus	1298	G	804	3	807	0.00011
Thermus	270	G	101	1	102	0.00001
Meiothermus	65551	G	49	0	49	0.00001
Oceanithermus	208447	G	26	0	26	0.00000
Allomeiothermus	2935559	G	25	0	25	0.00000
Marinithermus	186191	G	14	0	14	0.00000
Pyramidobacter	638847	G	441	11	452	0.00006
Jonquetella	428711	G	16	0	16	0.00000
Cloacibacillus	508459	G	235	15	250	0.00003
Aminomonas	81411	G	41	3	44	0.00001
Thermanaerovibrio	81461	G	20	1	21	0.00000
Fretibacterium	1434006	G	92	1	93	0.00001
Aminobacterium	81466	G	24	0	24	0.00000
Fervidobacterium	2422	G	51	1	52	0.00001
Thermosipho	2420	G	27	0	27	0.00000
Thermotoga	2335	G	41	0	41	0.00001
Marinitoga	160798	G	38	0	38	0.00001
Tepiditoga	2778400	G	25	0	25	0.00000
Petrotoga	28236	G	18	0	18	0.00000
Oceanotoga	1255275	G	17	0	17	0.00000
Mesotoga	1184396	G	24	0	24	0.00000
Kosmotoga	651456	G	11	0	11	0.00000
Athalassotoga	1769718	G	22	0	22	0.00000
Fusobacterium	848	G	964	22	986	0.00013
Ilyobacter	167639	G	52	0	52	0.00001
Cetobacterium	180162	G	49	0	49	0.00001
Leptotrichia	32067	G	195	2	197	0.00003
Sebaldella	32068	G	49	0	49	0.00001
Sneathia	168808	G	23	0	23	0.00000
Pseudoleptotrichia	2755140	G	18	0	18	0.00000
Haliovirga	3072462	G	26	0	26	0.00000
Candidatus Nanosynbacter	2093823	G	26	3	29	0.00000
Candidatus Southlakia	3350975	G	17	2	19	0.00000
Candidatus Minimicrobia	2905967	G	16	7	23	0.00000
Persicimonas	2766927	G	28	0	28	0.00000
Bradymonas	1779136	G	10	0	10	0.00000
Microvenator	2946507	G	14	0	14	0.00000
Dissulfurimicrobium	1769732	G	23	15	38	0.00001
Haloarcula	2237	G	127	11	138	0.00002
Halosimplex	171163	G	73	13	86	0.00001
Haloglomus	2806252	G	43	3	46	0.00001
Halorientalis	1073987	G	32	6	38	0.00001
Halomarina	871740	G	31	1	32	0.00000
Natronomonas	63743	G	30	10	40	0.00001
Halomicrobium	203135	G	30	1	31	0.00000
Salinirubellus	2162630	G	29	1	30	0.00000
Halorarius	3056835	G	22	12	34	0.00000
Halorhabdus	146825	G	20	0	20	0.00000
Halapricum	1542963	G	19	0	19	0.00000
Salinibaculum	2732368	G	12	1	13	0.00000
Halorubrum	56688	G	122	14	136	0.00002
Haloferax	2251	G	63	1	64	0.00001
Haloplanus	376170	G	58	5	63	0.00001
Halobaculum	43927	G	41	5	46	0.00001
Halorarum	3163375	G	31	4	35	0.00000
Salinigranum	1644057	G	24	1	25	0.00000
Haloprofundus	1911573	G	24	0	24	0.00000
Halobellus	1073986	G	18	2	20	0.00000
Halogeometricum	60846	G	16	0	16	0.00000
Natrinema	88723	G	75	7	82	0.00001
Natronorubrum	134813	G	38	2	40	0.00001
Natrarchaeobaculum	2765402	G	31	3	34	0.00000
Haloterrigena	121871	G	28	4	32	0.00000
Natronococcus	29287	G	23	1	24	0.00000
Natronosalvus	3076685	G	21	0	21	0.00000
Halovalidus	3383206	G	19	1	20	0.00000
Halovivax	332951	G	19	0	19	0.00000
Natronobacterium	2256	G	15	2	17	0.00000
Halomontanus	3125902	G	13	0	13	0.00000
Natribaculum	1699375	G	11	1	12	0.00000
Halosolutus	2993618	G	11	0	11	0.00000
Natrononativus	3065677	G	10	0	10	0.00000
Halorussus	1070314	G	66	11	77	0.00001
Haladaptatus	367188	G	47	2	49	0.00001
Halobacterium	2239	G	67	13	80	0.00001
Halarchaeum	744724	G	21	0	21	0.00000
Salarchaeum	1075398	G	14	2	16	0.00000
Halalkalicoccus	332246	G	17	0	17	0.00000
Halococcus	2249	G	15	0	15	0.00000
Salinarchaeum	1269201	G	13	0	13	0.00000
Methanosarcina	2207	G	87	0	87	0.00001
Methanolobus	2220	G	87	2	89	0.00001
Methanimicrococcus	91559	G	47	1	48	0.00001
Methanococcoides	2225	G	22	0	22	0.00000
Methanohalophilus	2175	G	16	0	16	0.00000
Methanofollis	81416	G	29	0	29	0.00000
Methanoculleus	45989	G	25	0	25	0.00000
Methanoplanus	2314	G	24	1	25	0.00000
Methanogenium	2195	G	20	0	20	0.00000
Methanochimaera	3385476	G	12	1	13	0.00000
Methanoregula	395331	G	41	0	41	0.00001
Methanospirillum	2202	G	38	0	38	0.00001
Methanocella	570266	G	25	0	25	0.00000
Methanothrix	2222	G	17	0	17	0.00000
Methanobrevibacter	2172	G	102	1	103	0.00001
Methanobacterium	2160	G	95	3	98	0.00001
Methanosphaera	2316	G	46	0	46	0.00001
Methanothermobacter	145260	G	20	0	20	0.00000
Methanocaldococcus	196118	G	39	1	40	0.00001
Methanococcus	2184	G	26	4	30	0.00000
Thermococcus	2263	G	89	0	89	0.00001
Pyrococcus	2260	G	51	5	56	0.00001
Archaeoglobus	2233	G	33	0	33	0.00000
Geoglobus	190818	G	27	0	27	0.00000
Candidatus Methanoplasma	1607807	G	16	0	16	0.00000
Methanomethylophilus	1291539	G	10	0	10	0.00000
Sulfolobus	2284	G	1394	0	1394	0.00019
Saccharolobus	2100760	G	36	0	36	0.00000
Sulfurisphaera	69655	G	15	0	15	0.00000
Staphylothermus	2279	G	17	2	19	0.00000
Ignicoccus	54258	G	13	0	13	0.00000
Pyrobaculum	2276	G	18	0	18	0.00000
Nitrososphaera	497726	G	30	0	30	0.00000
Candidatus Nitrosocosmicus	1826864	G	14	0	14	0.00000
Nitrosopumilus	338191	G	28	1	29	0.00000
Nitrosotalea	1078904	G	10	0	10	0.00000
Promethearchaeum	3366645	G	18	0	18	0.00000
Homo	9605	G	4269	135	4404	0.00060
Carjivirus	2948652	G	224752	0	224752	0.03065
Drivevirus	2948684	G	4054	0	4054	0.00055
Endlipuvirus	2948697	G	2570	0	2570	0.00035
Delmidovirus	2948688	G	624	0	624	0.00009
Dabirmavirus	2948671	G	34	0	34	0.00000
Whopevirus	2948952	G	22	0	22	0.00000
Jahgtovirus	2948767	G	1766	0	1766	0.00024
Fohxhuevirus	2948709	G	17	0	17	0.00000
Hacihdavirus	2948736	G	17	0	17	0.00000
Junduvirus	2948774	G	1197	0	1197	0.00016
Blohavirus	2942993	G	54	1	55	0.00001
Culoivirus	2942992	G	32	1	33	0.00000
Lebriduvirus	2948797	G	32	0	32	0.00000
Eponavirus	2733103	G	3292	5	3297	0.00045
Jouyvirus	2843396	G	402	4741	5143	0.00070
Moineauvirus	1623304	G	336	21	357	0.00005
Vansinderenvirus	3044850	G	13	11	24	0.00000
Lughvirus	2733190	G	115	1	116	0.00002
Eganvirus	2732978	G	31	558	589	0.00008
Peduovirus	140410	G	19	101	120	0.00002
Quadragintavirus	2948876	G	19	1	20	0.00000
Taranisvirus	2733134	G	49	3	52	0.00001
Oengusvirus	2733199	G	34	0	34	0.00000
Namakavirus	2733116	G	12	0	12	0.00000
Cebadecemvirus	2948654	G	20	0	20	0.00000
Skunavirus	1623305	G	16	0	16	0.00000
Krischvirus	1913651	G	14	0	14	0.00000
Brigitvirus	2733097	G	12	0	12	0.00000
Cronusvirus	2005059	G	11	0	11	0.00000
Tupanvirus	2094720	G	11	0	11	0.00000
Rheavirus	3044800	G	19	0	19	0.00000
Biavirus	3044674	G	17	0	17	0.00000
Alphabaculovirus	558016	G	19	0	19	0.00000
Betabaculovirus	558017	G	10	0	10	0.00000
